بيس	bess
الفنلندية	finland
سال	sal
سوسة	susa
الاستمرار	continue
شن	shun
شن	shin
اغسطس	aug
التصرف	disposition
ذهبت	gone
ايه	eh
داي	dey
داي	dai
اجتمع	met
تغذية	feed
مراعاة	observance
تفعيل	activate
يكشف	revealing
الدرجات	stairs
قبالة	off
المغناطيسية	magnetic
المقارنة	comparative
ابرز	highlight
بلو	blu
بلو	blue
الروحية	spiritual
يان	jan
يان	yan
مانع	mind
كليفلاند	cavs
روز	rose
فالي	valle
فالي	valley
القوس	sagittarius
تسلم	recognizes
العنصرية	racist
المشي	walk
هدى	huda
كراي	cray
كروز	cruise
الوقوف	stand
باك	buck
مماثل	similar
المكلا	mukalla
هاي	hai
هاي	hey
هاي	hay
فورت	fort
منغوليا	mongolian
اف	af
الاستاذ	prof
قياسي	standard
تام	tam
اكتساب	acquire
سين	sen
+,	+,
كيب	kip
بنا	us
زمان	zaman
هود	hood
السلفية	salafi
كاي	kai
دل	del
سكاي	sky
مشاركات	shares
رضوي	razavi
تشي	qi
تشي	chi
النسوية	feminist
لوح	wave
ساوث	south
كا	ka
ركوب	ride
عنف	violent
شيد	shed
وين	wen
مستر	mister
مستر	mr
بيكر	baker
تيمية	taymiyyah
شين	chin
شين	shin
تنزانيا	tanzanian
ليه	leh
البقاع	bekaa
الاشتراك	subscribe
ريفر	river
السند	bond
هاوس	house
الحفريات	fossils
ذهبي	gold
عموم	pan
مسبق	advance
احتفال	celebrating
مخالف	dissenting
فوج	fogg
حبيبي	baby
مزدوج	duplex
تطبق	applied
المتقدم	advance
موجه	vector
تنشيط	activate
النسر	vulture
فرعي	sub
التغلب	overcome
تحفيز	stimulate
زائد	plus
الحوت	pisces
الوفاء	fulfill
تسهيل	facilitate
ميديا	medea
تلبية	meet
العلمانية	secular
الكمال	perfect
بيتش	beach
بيتش	peach
ارتداء	wear
تكامل	integral
هوك	hook
هوك	hawk
السلف	predecessor
السلف	advances
فلو	flo
الفعال	effective
الكاف	caf
سنوي	snowy
فاسو	faso
المواهب	talent
استعداد	ready
استعداد	prepared
جثة	body
برو	prue
برو	pro
سويفت	swift
دوت	dot
الحلم	dreaming
شريحة	slice
داون	dawn
طقوس	rite
تنام	sleeping
البكر	pristine
رشح	filter
الجيولوجي	geologist
ذكاء	intelligent
ذكاء	smart
اكبر	akbar
درهم	dh
مير	mir
مير	mer
تسوية	settle
مكناس	meknès
مناهضة	anti
دوس	dos
شهيد	shahid
شهيد	shaheed
عون	awn
المستقيم	rectum
الصوفي	mystic
فو	foo
فو	pho
فو	fu
فو	phu
ترمز	symbolize
الميثاق	compact
باز	buzz
زيمبابوي	zimbabwean
تقوية	strengthen
فاتح	fatih
التحضير	preparing
توت	tut
مولود	born
العمالة	employment
وود	wood
المنبع	upstream
جرير	greer
مشعل	bonfire
محليا	local
لورد	lord
اللهم	god
سوس	soos
صغر	small
راح	will
عطاء	tender
تمرير	pass
ها	ha
ديربي	derby
