هاما	hama
اغسطس	augustus
براغ	prague
نجران	najran
مدغشقر	madagascar
كارلو	carlo
كاثرين	catherine
حنيفة	hanifa
تشيلسي	chelsea
ليتوانيا	lithuanian
ليتوانيا	lithuania
مايك	mike
دافيد	david
رامي	rami
ماركو	marco
لوكسمبورغ	luxembourg
البوندسليغا	bundesliga
الحمر	reds
كلينتون	clinton
التميمي	tamimi
تشاد	chad
تومي	tommy
كانو	cano
سامسونج	samsung
باول	paul
تلمسان	tlemcen
ماثيو	matthew
صيدا	saida
صيدا	sidon
غواتيمالا	guatemala
شعيب	shoaib
دانييل	daniel
مارغريت	margaret
سوزان	susan
كارولينا	carolina
نيبال	nepal
السوريين	syrians
بروكسل	brussels
الناصرة	nazareth
صوفي	sophie
رمسيس	rameses
فيفا	fifa
هامبورغ	hamburg
دجلة	tigris
الليثيوم	lithium
بنين	benin
وليم	william
شون	shawn
اسطنبول	istanbul
باتمان	batman
النيجر	niger
فلورنسا	florence
بورت	burt
ليوناردو	leonardo
بورما	burma
رمزي	ramzi
درعا	daraa
الصهيوني	zionist
ليلا	laila
بولونيا	bologna
نيكولا	nicola
الشيعية	shiite
هيلين	helen
ليلي	lily
فيشر	fisher
كول	cole
صغار	young
راسل	russell
شفيق	shafiq
كارتر	carter
نيفادا	nevada
القيروان	kairouan
القنيطرة	quneitra
هوليوود	hollywood
بوير	boyer
نعمان	noman
كركوك	kirkuk
فرح	farah
تشي	che
الشيرازي	shirazi
مونتريال	montreal
روتانا	rotana
بطليموس	ptolemy
باراغواي	paraguay
فرديناند	ferdinand
جيب	jeep
جامايكا	jamaica
وين	wayne
كوبنهاغن	copenhagen
وارسو	warsaw
ميلر	miller
بيتي	betty
لاوس	laos
رينيه	renee
لينين	lenin
حازم	hazem
بورقيبة	bourguiba
سلمى	selma
سلمى	salma
غسان	ghassan
طلحة	talha
ستيفان	stefan
هوارد	howard
كيلي	kelly
دمياط	damietta
ميلا	mila
جيرمان	germain
السند	sindh
بلانك	planck
بلانك	plank
جيري	jerry
سنان	sinan
مكتوم	maktoum
مكسيكو	mexico
لورنس	lawrence
البشير	bashir
هلسنكي	helsinki
براين	brian
هان	han
زنجبار	zanzibar
بون	bonn
بلغراد	belgrade
نينوى	nineveh
ساكسونيا	saxony
ليفي	levy
فوج	vogue
كونيتيكت	connecticut
بادن	baden
بوخارست	bucharest
كلود	claude
داروين	darwin
كارول	carol
كوسوفو	kosovo
القطيف	qatif
جونغ	jung
تروي	troy
طلعت	talat
ميغيل	miguel
نيلسون	nelson
لوثر	luther
وو	wu
جوني	johnny
البلطيق	baltic
ياسمين	jasmine
لوبيز	lopez
بسام	bassam
جوليا	julia
شارلوت	charlotte
ديانا	diana
حمادة	hamada
هانز	hans
حنا	hanna
تامر	tamer
هارت	hart
الحبشة	abyssinia
ميرزا	mirza
جيبوتي	djibouti
نولان	nolan
موراي	moray
موراي	murray
نادية	nadia
ديف	dave
ديف	dev
عفان	affan
تيودور	theodore
تيودور	tudor
نايت	nate
بوركينا	burkina
زامبيا	zambia
ليبي	libby
الرفاع	riffa
داني	danny
رويس	royce
تبوك	tabuk
نيكولاي	nikolai
نيكولاي	nicolae
ستانفورد	stanford
هابل	hubble
كوبر	cooper
ستوكهولم	stockholm
باراك	barack
باراك	barak
ويل	will
نضال	nidal
فريمان	freeman
ريانا	rihanna
مولى	molly
بيغ	peg
كريستي	christy
هالة	hala
الطبري	tabari
الكسندر	alexander
قزوين	caspian
كيفن	kevin
مارسيليا	marseilles
حنبل	hanbal
القاسمي	qasimi
السامي	sami
هوندا	honda
كلير	claire
الناتو	nato
البنا	banna
غارسيا	garcia
غرامي	grammy
بنيامين	benjamin
زيمبابوي	zimbabwe
تشارلي	charlie
بدوي	badawi
نيوكاسل	newcastle
جوليان	julian
بيني	penny
الخميني	khomeini
انجلترا	england
فرحات	farhat
كوين	quinn
لوكاس	lucas
سانتوس	santos
هرقل	hercules
ستانلي	stanley
بارما	parma
يونكس	unix
جبريل	gabriel
خديجة	khadija
الكرك	karak
تشو	chu
تشو	cho
اليوتيوب	youtube
السليمانية	sulaymaniyah
باسكال	pascal
فرنسيس	francis
عاطف	atef
رونالدو	ronaldo
بيلا	bella
ملبورن	melbourne
ثور	thor
ريكاردو	ricardo
لادن	laden
صلالة	salalah
وفاء	wafa
مونت	mont
مونت	monte
زارة	zaara
جيف	jeff
هندوراس	honduras
ممدوح	mamdouh
روميو	romeo
مايا	maya
بانياس	baniyas
فاي	faye
فاي	fae
البيطار	bitar
رون	ron
جيوفاني	giovanni
