висконти	visconti
ове	ove
липе	lipe
оод	ood
ело	elo
индо	indo
дева	deva
казан	kazan
дебър	debar
брабант	brabant
брод	brod
платна	sails
неа	nea
коло	colo
струга	struga
сок	sock
ресен	resen
чака	chaka
отсъствие	absent
сул	sul
тор	tor
вулкан	vulcan
ниши	nishi
увреждания	disabled
къс	cus
завой	bend
перо	pero
