харолд	harold
димитровград	dimitrovgrad
дани	danny
дани	dani
кейт	kate
спарта	sparta
андон	andon
ада	ada
лотар	lothar
егейско	aegean
айова	iowa
минесота	minnesota
валдек	waldeck
йънг	young
маями	miami
йон	yoon
йон	yeon
венето	veneto
петрович	petrovic
петрович	petrovich
валоа	valois
радомир	radomir
остин	austen
остин	austin
холивуд	hollywood
бахрейн	bahrain
айлънд	island
лоренцо	lorenzo
лимбург	limburg
волга	volga
севиля	sevilla
севиля	seville
сиена	sienna
сиена	siena
уисконсин	wisconsin
олег	oleg
демир	demir
мюлер	müller
мюлер	mueller
мюлер	muller
елен	ellen
елен	helene
волфенбютел	wolfenbüttel
кен	ken
ванка	ivan
кентъки	kentucky
батенберг	battenberg
вернер	werner
кънектикът	connecticut
созопол	sozopol
гамбия	gambia
глен	glen
глен	glenn
романя	romagna
враня	vranje
оод	ltd
лейк	lake
моника	monica
моника	monika
никозия	nicosia
прованс	provence
хюстън	houston
робин	robin
джеф	jeff
йоахим	joachim
райън	ryan
гордън	gordon
димитриос	dimitrios
сараево	sarajevo
майер	meier
майер	mayer
майер	meyer
франко	franco
франко	franko
мериленд	maryland
палермо	palermo
грузински	georgian
кастро	castro
джейсън	jason
медина	medina
линкълн	lincoln
дисни	disney
костадинов	kostadinov
дионисий	dionysus
агрипа	agrippa
монреал	montreal
тонга	tonga
белица	bjelica
лукас	lucas
лукас	lukas
чан	chan
таймс	times
коларов	kolarov
яне	janne
верона	verona
доналд	donald
султана	sultana
путин	putin
свиленград	svilengrad
тото	toto
гревена	grevena
вавилон	babylon
невада	nevada
месопотамия	mesopotamia
марек	marek
кайзерслаутерн	kaiserslautern
дакота	dakota
дряново	dryanovo
хелзинки	helsinki
анкара	ankara
ръсел	russel
ръсел	russell
люк	luke
андреас	andreas
лусия	lucia
арагон	aragon
трифонов	trifonov
сфорца	sforza
модена	modena
сейшели	seychelles
нормандия	normandy
клеопатра	cleopatra
магнус	magnus
роналд	ronald
катар	qatar
доминика	dominica
кеймбридж	cambridge
гренландия	greenland
людмила	ludmilla
оливър	oliver
лозенград	kırklareli
ватикана	vatican
антония	antonia
ванкувър	vancouver
еберхард	eberhard
рикардо	riccardo
рикардо	ricardo
здравко	zdravko
морган	morgan
пиетро	pietro
уайлд	wilde
реймънд	raymond
мариана	marianna
мариана	mariana
сопот	sopot
мориц	moritz
роналдо	ronaldo
марта	marta
марта	martha
йоханес	johannes
карол	karol
карол	carol
тимор	timor
николаос	nikolaos
цвайбрюкен	zweibrücken
радванска	radwańska
стивънс	stephens
стивънс	stevens
алан	allan
мездра	mezdra
мара	mara
бийч	beech
ясна	jasna
шерлок	sherlock
осман	osman
орфей	orpheus
падуа	padua
уейн	wayne
брут	brutus
хърбърт	herbert
фишер	fisher
фишер	fischer
тетово	tetovo
моцарт	mozart
тодорова	todorova
дженифър	jennifer
елин	elin
детройт	detroit
хънт	hunt
херодот	herodotus
павлович	pavlovich
хабсбург	habsburg
томи	tommy
мърфи	murphy
бесарабия	bessarabia
кей	kay
ума	uma
дамаск	damascus
радослав	radoslav
драган	dragan
трявна	tryavna
силва	silva
майсен	meissen
баку	baku
рой	roy
луиджи	luigi
вестфалия	westphalia
таня	tania
таня	tanya
таня	tanja
бъркли	berkley
бъркли	berkeley
джан	jan
джан	zhang
саймън	simon
лийдс	leeds
шумахер	schumacher
плутарх	plutarch
базел	basel
гаврил	gavril
наталия	natalya
наталия	natalia
кери	carrie
кери	cary
кери	kerry
леонард	leonard
ален	alain
гуам	guam
оксфорд	oxford
аквитания	aquitaine
сет	seth
бенджамин	benjamin
каменица	kamenica
абдул	abdul
светлана	svetlana
пен	penn
поморие	pomorie
луизиана	louisiana
хофман	hoffmann
хофман	hoffman
мей	mei
апостолов	apostolov
мирослав	miroslav
вегас	vegas
бенедикт	benedict
бенедикт	benedick
швабия	swabia
катя	katia
катя	katya
катя	katja
никита	nikita
дик	dick
санчес	sanchez
нина	nina
нбу	nbu
белене	belene
вагнер	wagner
диленбург	dillenburg
нютон	newton
винсент	vincent
палма	palma
татяна	tatiana
татяна	tatyana
сократ	socrates
минск	minsk
рот	roth
шварцбург	schwarzburg
гугъл	google
мусолини	mussolini
ранд	rand
алесандро	alessandro
уикимедия	wikimedia
пери	peri
пери	perry
пери	parry
трансилвания	transylvania
фрг	frg
барбароса	barbarossa
мурад	murad
кирибати	kiribati
анатолий	anatoly
гота	gota
колин	collin
колин	colin
фриц	fritz
силезия	silesia
елиът	elliott
елиът	eliot
елиът	elliot
мейн	maine
каринтия	carinthia
съливан	sullivan
райт	wright
ферара	ferrara
нанси	nancy
шанхай	shanghai
душан	dusan
ерани	errani
джоан	joanne
джоан	joan
енрике	enrique
мелбърн	melbourne
вердер	werder
разлог	razlog
океания	oceania
надя	nadja
надя	nadya
надя	nadia
нестор	nestor
залцбург	salzburg
мак	mac
мак	mack
киро	kiro
лауда	lauda
паркър	parker
тувалу	tuvalu
алис	alice
куинсланд	queensland
каварна	kavarna
бирмингам	birmingham
кралици	queens
ралф	ralph
антоан	antoine
антиохия	antioch
аякс	ajax
уолис	wallis
батак	batak
джефри	geoffrey
джефри	jeffrey
крус	cruz
тива	thebes
кристоф	kristoff
кристоф	christophe
кристоф	christoph
гьоте	goethe
джесика	jessica
толстой	tolstoy
ибрахим	ibrahim
жозеф	joseph
науру	nauru
антоанета	antoinette
цецилий	caecilius
нахия	nahiyah
сюзън	susan
сеул	seoul
панония	pannonia
панчо	pancho
тор	thor
агиос	agios
хайделберг	heidelberg
папи	papi
папи	pappy
дъблин	dublin
зигфрид	siegfried
юлих	jülich
търнър	turner
матиас	mathias
матиас	mattias
матиас	matias
матиас	matthias
свазиленд	swaziland
йован	jovan
дион	deion
дион	dion
дион	dionne
армстронг	armstrong
манхатън	manhattan
томпсън	thompson
прадеш	pradesh
мелник	melnick
иларион	ilarion
кобург	coburg
багдад	baghdad
арканзас	arkansas
хюсеин	hussein
хюсеин	hussain
хюсеин	hüseyin
батман	batman
първанов	parvanov
рейчъл	rachel
роуз	rose
колинс	collins
дарвин	darwin
братислава	bratislava
нели	nelly
нели	nellie
септимий	septimius
милена	milena
янкович	jankovic
томов	tomov
айнщайн	einstein
лора	laura
лора	lora
младен	mladen
зигмунд	sigmund
евдокия	eudokia
лихтенщайн	liechtenstein
лихтенщайн	lichtenstein
беатрис	beatrice
беатрис	beatriz
суматра	sumatra
лентул	lentulus
кадафи	gaddafi
харисън	harrison
елзас	alsace
хрушчов	khrushchev
сервилий	servilius
деян	dejan
лидия	lidia
лидия	lydia
антонин	antonin
пелопонес	peloponnese
раул	raoul
раул	raul
емили	emilie
емили	emily
таун	towne
соломон	solomon
теодорих	theuderic
джеси	jessie
джеси	jesse
велбъжд	velbazhd
глазгоу	glasgow
кейн	cain
кейн	kane
кейн	cane
кейн	caine
моравия	moravia
страбон	strabo
лена	lena
хендрикс	hendricks
хендрикс	hendrix
пиеро	pierrot
пиеро	piero
петра	petra
желев	zhelev
тбилиси	tbilisi
алпите	alps
померания	pomerania
кожани	kozani
фитипалди	fittipaldi
арктика	arctic
