indonesien	indonesia
inge	inge
express	express
toronto	toronto
kat	kat
bülow	bülow
marseille	marseille
uci	uci
knuth	knuth
ltd	ltd
ken	ken
dallas	dallas
ærø	ærø
muhammed	muhammad
muhammed	muhammed
marco	marco
watson	watson
vig	vig
toyota	toyota
struer	struer
montenegro	montenegro
budapest	budapest
campbell	campbell
nigeria	nigeria
armstrong	armstrong
samtgemeinde	samtgemeinde
etiopien	ethiopia
mitchell	mitchell
carter	carter
bmw	bmw
row	row
ballerup	ballerup
abu	abu
dean	dean
mind	mind
cape	cape
frederikssund	frederikssund
soundtrack	soundtrack
camilla	camilla
karin	karin
møn	møn
delta	delta
sen	sen
tunnel	tunnel
rolf	rolf
val	val
tina	tina
ulla	ulla
ronald	ronald
vegas	vegas
winther	winther
bundesliga	bundesliga
elo	elo
johansson	johansson
nintendo	nintendo
vancouver	vancouver
benz	benz
points	points
speciale	speciale
heiberg	heiberg
orleans	orleans
sean	sean
cruz	cruz
hal	hal
thy	thy
thorvald	thorvald
phoenix	phoenix
kassel	kassel
historia	historia
randy	randy
jessen	jessen
aaron	aaron
clemens	clemens
miami	miami
aus	aus
fogh	fogh
ehf	ehf
lloyd	lloyd
ball	ball
tel	tel
kenya	kenya
mogensen	mogensen
jennifer	jennifer
kings	kings
larry	larry
luke	luke
malta	malta
holck	holck
glasgow	glasgow
secret	secret
mikhail	mikhail
stan	stan
mil	mil
bernstorff	bernstorff
wrestlemania	wrestlemania
colorado	colorado
monica	monica
manageryears	manageryears
banks	banks
tove	tove
jupiter	jupiter
xbox	xbox
anhalt	anhalt
betty	betty
atlantic	atlantic
helena	helena
daf	daf
dick	dick
helene	helene
klint	klint
spin	spin
boris	boris
düsseldorf	düsseldorf
düsseldorf	dusseldorf
highway	highway
montreal	montreal
sehested	sehested
ris	ris
julian	julian
henderson	henderson
paulo	paulo
fdf	fdf
singer	singer
lego	lego
manhattan	manhattan
nysted	nysted
css	css
level	level
ivar	ivar
diana	diana
cornelius	cornelius
algeriet	algeria
über	über
cleveland	cleveland
elseif	elseif
jer	jer
saa	saa
juventus	juventus
ingrid	ingrid
holmes	holmes
boldklubben	boldklubben
tree	tree
porto	porto
balkan	balkans
edgar	edgar
angels	angels
nhl	nhl
neil	neil
eyes	eyes
maryland	maryland
buenos	buenos
control	control
eduard	eduard
oklahoma	oklahoma
bella	bella
sierra	sierra
tung	tung
harrison	harrison
gaza	gaza
pyrénées	pyrénées
aires	aires
raf	raf
kirk	kirk
jamie	jamie
hunter	hunter
catherine	catherine
limfjorden	limfjord
woman	woman
vibeke	vibeke
philippe	philippe
danneskiold	danneskiold
heaven	heaven
istanbul	istanbul
husum	husum
montgomery	montgomery
inter	inter
edmund	edmund
moses	moses
pacific	pacific
pommern	pomerania
erich	erich
egon	egon
houston	houston
langeland	langeland
flandern	flanders
borussia	borussia
cbs	cbs
cecilie	cecilie
owen	owen
rafael	raphael
rafael	rafael
filippinerne	philippines
alabama	alabama
newton	newton
michelle	michelle
olga	olga
sevilla	sevilla
sevilla	seville
mel	mel
ronnie	ronnie
walker	walker
ruth	ruth
wikidata	wikidata
stein	stein
pearl	pearl
winston	winston
emmy	emmy
oldenburg	oldenburg
dortmund	dortmund
police	police
dragon	dragon
göttingen	göttingen
chopin	chopin
gad	gad
pedro	pedro
barry	barry
judas	judas
kentucky	kentucky
nassau	nassau
simpson	simpson
leth	leth
nepal	nepal
westfalen	westphalia
amy	amy
walk	walk
rick	rick
rob	rob
leftarm	leftarm
cypern	cyprus
mitsubishi	mitsubishi
seg	seg
motors	motors
samsø	samsø
cia	cia
richmond	richmond
lissabon	lisbon
grace	grace
sct	sct
reform	reform
grenaa	grenaa
clara	clara
rudolph	rudolph
pinyin	pinyin
ward	ward
support	support
inn	inn
magic	magic
augustus	augustus
iau	iau
voice	voice
cameron	cameron
holberg	holberg
bjerre	bjerre
walt	walt
shakespeare	shakespeare
hudson	hudson
schwerin	schwerin
susan	susan
elben	elbe
karsten	karsten
currentclub	currentclub
broadway	broadway
armenien	armenia
hand	hand
taastrup	taastrup
munch	munch
busk	busk
lauritz	lauritz
jespersen	jespersen
wallace	wallace
glenn	glenn
elite	elite
jakobsen	jakobsen
jules	jules
bloch	bloch
memorial	memorial
polo	polo
tunesien	tunisia
hood	hood
tobias	tobias
peters	peters
venezuela	venezuela
alexandria	alexandria
østergaard	østergaard
saturn	saturn
ridge	ridge
classic	classic
newcastle	newcastle
ontario	ontario
panzer	panzer
svendsen	svendsen
gottorp	gottorp
iversen	iversen
gemeinden	gemeinden
ikast	ikast
track	track
eastwood	eastwood
marcel	marcel
leonard	leonard
halle	halle
birger	birger
seattle	seattle
mozart	mozart
adm	adm
evil	evil
vestindien	caribbean
zulu	zulu
winter	winter
gert	gert
peace	peace
ralph	ralph
mare	mare
percussion	percussion
grethe	grethe
hope	hope
struensee	struensee
theol	theol
vagn	vagn
command	command
joakim	joakim
christoph	christoph
simpsons	simpsons
wta	wta
madison	madison
atlético	atlético
blom	blom
crash	crash
devil	devil
lead	lead
montana	montana
brock	brock
nash	nash
hald	hald
gilbert	gilbert
kosovo	kosovo
torino	torino
martha	martha
germain	germain
seat	seat
freja	freja
limited	limited
murphy	murphy
tromsø	tromsø
brønshøj	brønshøj
diamond	diamond
edge	edge
jürgen	jürgen
knight	knight
bertel	bertel
hugh	hugh
thorning	thorning
ram	ram
tna	tna
justin	justin
lau	lau
gestapo	gestapo
eminem	eminem
andersson	andersson
coast	coast
leon	leon
leonardo	leonardo
brygge	brygge
denis	denis
event	event
kattegat	kattegat
israelsk	israel
lane	lane
tottenham	tottenham
suðuroy	suðuroy
ægypten	egypt
nicholas	nicholas
mann	mann
canal	canal
hulk	hulk
playoff	playoff
interviews	interviews
lara	lara
kierkegaard	kierkegaard
piper	piper
banner	banner
helen	helen
balance	balance
holmen	holmen
uffe	uffe
hogwarts	hogwarts
españa	españa
child	child
krim	crimea
sub	sub
sultan	sultan
hercegovina	herzegovina
abel	abel
adrian	adrian
svalbard	svalbard
brooklyn	brooklyn
discovery	discovery
lukas	lukas
avenue	avenue
kid	kid
spencer	spencer
alberto	alberto
nansen	nansen
philipp	philipp
wang	wang
christie	christie
greg	greg
roberts	roberts
unger	unger
discogs	discogs
comeback	comeback
freedom	freedom
rex	rex
pol	pol
burma	burma
eckersberg	eckersberg
tchad	chad
depression	depression
steffen	steffen
wiener	wiener
colin	colin
spd	spd
mongoliet	mongolia
interwiki	interwiki
matthias	matthias
moss	moss
face	face
flair	flair
break	break
radar	radar
elias	elias
hertz	hertz
nancy	nancy
glee	glee
spirit	spirit
iss	iss
thott	thott
ækvator	equator
shepherd	shepherd
thompson	thompson
aristoteles	aristotle
blank	blank
alpes	alpes
nature	nature
asger	asger
speed	speed
zagreb	zagreb
leningrad	leningrad
atlantis	atlantis
oder	oder
roland	roland
turner	turner
wing	wing
eit	eit
ligue	ligue
joan	joan
hud	hud
landing	landing
samsøe	samsøe
bin	bin
floyd	floyd
liège	liège
bros	bros
ulfeldt	ulfeldt
iowa	iowa
butler	butler
kaos	kaos
marina	marina
augustenborg	augustenburg
cfg	cfg
pablo	pablo
split	split
johnston	johnston
luftwaffe	luftwaffe
paradise	paradise
sri	sri
cola	cola
overlay	overlay
queens	queens
moser	moser
emilie	emilie
utah	utah
joint	joint
juliane	juliane
mainsnak	mainsnak
dagmar	dagmar
craig	craig
distribution	distribution
bonn	bonn
dtu	dtu
gottlieb	gottlieb
jung	jung
sheffield	sheffield
truman	truman
harbor	harbor
viby	viby
cm³	cm³
wisconsin	wisconsin
deutschen	deutschen
crystal	crystal
sid	sid
homo	homo
malcolm	malcolm
cat	cat
wanderers	wanderers
commonwealth	commonwealth
dos	dos
oregon	oregon
bordeaux	bordeaux
earl	earl
heeresgruppe	heeresgruppe
stage	stage
salling	salling
skovgaard	skovgaard
dinesen	dinesen
maine	maine
malling	malling
friends	friends
tang	tang
maximilian	maximilian
suzuki	suzuki
jelena	jelena
medina	medina
konrad	konrad
rocky	rocky
henningsen	henningsen
larsson	larsson
footballdatabase	footballdatabase
schrøder	schrøder
edith	edith
olof	olof
