andy	andy
lost	lost
java	java
alfons	alfons
alfons	afonso
alfons	alfonso
reichstag	reichstag
lisa	lisa
mozart	mozart
allianz	allianz
pietro	pietro
cruz	cruz
melbourne	melbourne
pius	pius
lausanne	lausanne
québec	québec
québec	quebec
nba	nba
detail	detail
landesamt	landesamt
xii	xii
maría	maría
olympia	olympia
johan	johan
margaret	margaret
arizona	arizona
franklin	franklin
bde	bde
comic	comic
rue	rue
harris	harris
janeiro	janeiro
vancouver	vancouver
ronald	ronald
peters	peters
klagenfurt	klagenfurt
lincoln	lincoln
marken	marche
lasse	lasse
schiller	schiller
sven	sven
norman	norman
player	player
siemens	siemens
mini	mini
ernest	ernest
wen	wen
puerto	puerto
schäfer	schaefer
schäfer	schäfer
oswald	oswald
magdalena	magdalene
magdalena	magdalena
mdr	mdr
frisch	frisch
kelly	kelly
alabama	alabama
loire	loire
alberto	alberto
mmn	mmn
connecticut	connecticut
kaliningrad	kaliningrad
guido	guido
xvi	xvi
vietnam	vietnam
uruguay	uruguay
gruyter	gruyter
liechtenstein	liechtenstein
liechtenstein	lichtenstein
holocaust	holocaust
siegel	siegel
hamm	hamm
auschwitz	auschwitz
detroit	detroit
emma	emma
bukarest	bucharest
maine	maine
kongo	congo
hofmann	hofmann
südkorea	korea
grimm	grimm
anr	anr
engineering	engineering
browser	browser
eintracht	eintracht
vfb	vfb
harz	harz
lars	lars
lucas	lucas
südtirol	südtirol
henning	henning
moon	moon
notre	notre
riga	riga
madonna	madonna
roberto	roberto
laura	laura
marianne	marianne
mathias	mathias
mont	mont
belgrad	belgrade
maryland	maryland
kats	kats
sofia	sofia
abu	abu
glasgow	glasgow
heller	heller
emanuel	emanuel
emanuel	emmanuel
graham	graham
caroline	caroline
marokko	morocco
ryan	ryan
renault	renault
turner	turner
dorothea	dorothea
suhrkamp	suhrkamp
gilbert	gilbert
estland	estonia
clara	clara
nad	nad
sierra	sierra
meißen	meissen
stralsund	stralsund
kennedy	kennedy
karin	karin
mönchengladbach	mönchengladbach
minden	minden
campbell	campbell
franco	franco
lukas	luke
lukas	lukas
lukas	lucas
morgan	morgan
sat	sat
steven	steven
parker	parker
hanns	hanns
thompson	thompson
konstantinopel	constantinople
konstantinopel	istanbul
henriette	henrietta
henriette	henriette
robinson	robinson
legend	legend
dennis	dennis
mien	mien
bologna	bologna
björn	bjorn
björn	björn
kolumbien	columbia
kolumbien	colombia
dublin	dublin
gabriele	gabriele
planck	planck
luigi	luigi
ken	ken
louisiana	louisiana
taiwan	taiwan
amazon	amazon
shakespeare	shakespeare
forst	forst
lehmann	lehmann
classic	classic
med	med
jonas	jonas
jonas	jonah
adolph	adolph
mhz	mhz
uci	uci
carter	carter
princeton	princeton
atlanta	atlanta
antwerpen	antwerpen
antwerpen	antwerp
kaiserslautern	kaiserslautern
bks	bks
antonius	anthony
antonius	antony
antonius	antonius
muhammad	muhammad
julian	julian
nil	nil
nil	nile
sant	sant
altenburg	altenburg
abc	abc
kiew	kyiv
kiew	kiev
faust	faust
evans	evans
apple	apple
cooper	cooper
ulmer	ulmer
schubert	schubert
brigitte	brigitte
barry	barry
veb	veb
posen	poznan
posen	poznań
posen	posen
wenzel	wenzel
type	type
metz	metz
harold	harold
brothers	brothers
gene	gene
silva	silva
christ	christ
miami	miami
shanghai	shanghai
mexico	mexico
lahn	lahn
baker	baker
copa	copa
udo	udo
división	división
hansen	hansen
catherine	catherine
bodensee	bodensee
rowohlt	rowohlt
murray	murray
austin	austin
kunsthalle	kunsthalle
rüdiger	rüdiger
porto	porto
porto	oporto
interviews	interviews
bismarck	bismarck
monika	monika
flensburg	flensburg
pakistan	pakistan
grant	grant
salvador	salvador
saarland	saarland
dakota	dakota
egon	egon
utrecht	utrecht
control	control
tiger	tiger
lichtenberg	lichtenberg
wang	wang
liverpool	liverpool
ringer	ringer
roll	roll
broadway	broadway
jason	jason
alaska	alaska
matthew	matthew
helene	helene
helene	helen
vogt	vogt
angela	angela
margarete	margaret
margarete	margarete
syn	syn
ruprecht	rupert
ruprecht	ruprecht
head	head
leonard	leonard
disney	disney
offenbach	offenbach
sky	sky
köhler	köhler
jorge	jorge
elsass	alsace
italia	italia
eisenach	eisenach
oregon	oregon
christina	christina
rks	rks
schreiber	schreiber
dell	dell
joan	joan
bremerhaven	bremerhaven
wls	wls
slowenien	slovenia
jerry	jerry
hawaii	hawaii
jules	jules
under	under
rotterdam	rotterdam
haute	haute
homburg	homburg
montana	montana
wayne	wayne
dessau	dessau
meier	meier
morris	morris
gertrud	gertrude
gertrud	gertrud
malte	malte
hitlers	hitler
dnb	dnb
petra	petra
bosnien	bosnia
wright	wright
sergei	sergei
sergei	sergey
berkeley	berkeley
gerald	gerald
angel	angel
hartmut	hartmut
funk	funk
herrmann	herrmann
schumacher	schumacher
valentin	valentin
valentin	valentine
brandt	brandt
oklahoma	oklahoma
vorarlberg	vorarlberg
venezuela	venezuela
reinbek	reinbek
nina	nina
ingrid	ingrid
krüger	kruger
krüger	krüger
krüger	krueger
rosenberg	rosenberg
chaos	chaos
xaver	xaver
xaver	xavier
cornelius	cornelius
bobby	bobby
imo	imo
gem	gem
ndr	ndr
garcía	garcia
garcía	garcía
orleans	orleans
orleans	orléans
eddie	eddie
baltimore	baltimore
berthold	berthold
xiv	xiv
mohammed	mohammad
mohammed	muhammad
mohammed	mohammed
mohammed	mohamed
arkansas	arkansas
indonesien	indonesia
paolo	paolo
gestapo	gestapo
marshall	marshall
gütersloh	gütersloh
houston	houston
adrian	adrian
musée	musée
zagreb	zagreb
krakau	cracow
krakau	krakow
krakau	kraków
zypern	cyprus
jeff	jeff
germania	germania
jon	jon
schmitt	schmitt
hills	hills
baptist	baptist
bundesverdienstkreuz	bundesverdienstkreuz
wta	wta
drum	drum
gera	gera
burgund	bourgogne
burgund	burgundy
pauli	pauli
xiii	xiii
marseille	marseille
marseille	marseilles
hugh	hugh
chen	chen
leon	leon
duden	duden
beethoven	beethoven
krefeld	krefeld
tommy	tommy
rgb	rgb
tool	tool
görlitz	görlitz
kairo	cairo
olaf	olaf
avenue	avenue
départements	départements
kunstverein	kunstverein
schumann	schumann
lorenzo	lorenzo
wolfram	wolfram
roberts	roberts
hirsch	hirsch
ludwigs	ludwig
nancy	nancy
hunter	hunter
krieger	krieger
eichstätt	eichstätt
armin	armin
brockhaus	brockhaus
ivan	ivan
edwin	edwin
kent	kent
bond	bond
mitchell	mitchell
marion	marion
schwarzwald	schwarzwald
ingolstadt	ingolstadt
cottbus	cottbus
theo	theo
sony	sony
raf	raf
ansbach	ansbach
collins	collins
terry	terry
schulze	schulze
dehio	dehio
six	six
krebs	krebs
girls	girls
alain	alain
historique	historique
achim	achim
michail	mikhail
globe	globe
nicholas	nicholas
palästina	palestine
wilfried	wilfred
wilfried	wilfried
fürth	fürth
mtv	mtv
rudolph	rudolph
dallas	dallas
herman	herman
krause	krause
messina	messina
bsg	bsg
kosovo	kosovo
