geneva	جنيف
blade	بليد
cohen	كوهين
mesa	ميسا
prussia	بروسيا
ellen	ايلين
ellen	الين
paradise	الفردوس
diana	ديانا
americas	الامريكتين
silva	سيلفا
derek	ديريك
trinidad	ترينيداد
burke	بيرك
burke	بورك
willie	ويلي
collaborated	تعاونت
heinrich	هينريش
ethiopia	اثيوبيا
edwin	ادوين
brighton	برايتون
brighton	بريتون
viola	فيولا
morrison	موريسون
ernst	ارنست
boeing	بوينج
boeing	بوينغ
rosa	روزا
speculation	مضاربة
burma	بورما
sec	sec
estonian	الاستونية
sofia	صوفيا
pounds	جنيه
rica	ريكا
macdonald	ماكدونالد
atp	atp
kosovo	كوسوفو
julius	جوليوس
naples	نابولي
sebastian	سباستيان
sebastian	سيباستيان
barnes	بارنز
martha	مارثا
elliott	اليوت
randy	راندي
annie	اني
annie	انى
rhine	الراين
charleston	شارلستون
charleston	تشارلستون
guatemala	غواتيمالا
dorothy	دوروثي
dorothy	دورثي
richards	ريتشاردز
theodore	تيودور
blair	بلير
stan	ستان
wwe	wwe
anton	انتون
anton	انطون
moses	موسى
troy	تروي
roberto	روبرتو
roberto	روبيرتو
johnston	جونستون
norton	نورتون
jorge	خورخي
latvia	ولاتفيا
latvia	لاتفيا
hardy	هاردي
nat	نات
nottingham	نوتينغهام
nottingham	نوتنغهام
crawford	كروفورد
crawford	كراوفورد
tanzania	تنزانيا
hayes	هيز
xbox	بوكس
forbes	فوربس
forbes	فوربز
bach	باخ
claire	كلير
bruno	برونو
dylan	ديلين
dylan	ديلن
dylan	ديلان
churchill	تشرشل
thames	التايمز
kazakhstan	كازاخستان
slovak	السلوفاكية
slovak	سلوفاكيا
stern	ستيرن
cairo	القاهره
cairo	القاهرة
logan	لوغان
logan	لوجان
jessica	جيسيكا
walsh	والش
walsh	وولش
suffolk	suffolk
suffolk	سوفولك
garcia	غارسيا
madagascar	مدغشقر
minneapolis	مينيابوليس
kerry	كيري
lou	لو
lou	لوو
joshua	جوشوا
casey	كيسي
casey	كايسي
dubai	dubai
michelle	ميشيل
clara	كلارا
mhz	mhz
jeffrey	جيفري
swift	سويفت
newman	نيومان
beatles	البيتلز
jacksonville	جاكسونفيل
brandon	براندون
für	für
griffin	جريفين
griffin	غريفين
griffin	غريفن
rhodes	رودز
rhodes	رودس
itv	itv
ana	ana
jackie	جاكي
homer	هومر
chang	تشانغ
chad	تشاد
chad	شاد
ashley	اشلي
gif	gif
nascar	ناسكار
nascar	الناسكار
rpm	rpm
boris	بوريس
berry	بيري
maxwell	ماكسويل
felix	فيلكس
felix	فيليكس
timothy	تيموثي
krishna	كريشنا
darwin	داروين
madonna	مادونا
winston	ونستون
winston	وينستون
llc	llc
nrhp	nrhp
drake	دريك
drake	درايك
patricia	باتريشيا
ers	ers
aberdeen	aberdeen
santo	سانتو
roland	رولاند
sherman	شيرمان
stefan	ستيفان
carnegie	كارنيغي
carnegie	كارنيجي
geoffrey	جيوفري
geoffrey	جيفري
osaka	اوساكا
baldwin	بالدوين
sixty	sixty
francesco	فرانشيسكو
monica	مونيكا
deutsche	deutsche
pablo	بابلو
aviv	ابيب
janet	جانيت
genesis	جينيسيس
catholicism	الكاثوليكية
luther	لوثر
webb	ويب
alberto	البرتو
kiev	كييف
vista	فيستا
castro	كاسترو
wei	وي
itunes	itunes
herman	هيرمان
sally	سالي
rex	ريكس
afghan	افغانستان
vatican	الفاتيكان
vicinity	الجوار
tehran	تهران
tehran	طهران
amanda	اماندا
nixon	نيكسون
helsinki	هلسنكي
bedford	بيدفورد
cambodia	كمبوديا
jung	جونغ
jung	جونج
jung	جيونغ
libya	ليبيا
angela	انجيلا
android	android
freeman	فريمان
meyer	ماير
lima	ليما
wong	ونغ
wong	وونغ
cumberland	كمبرلاند
chennai	تشيناي
dong	دونج
dong	دونغ
myanmar	ميانمار
penny	بيني
chapman	تشابمان
chapman	شابمان
riley	رايلي
riley	رايلى
haiti	هاييتي
haiti	هايتي
alma	الما
alexandra	الكسندرا
eva	ايفا
mickey	ميكي
yuan	يوان
lynch	لينش
johannes	يوهانس
adolf	ادولف
sharon	شارون
hung	هونغ
mohammed	محمد
mohammed	mohammed
reagan	ريجان
rebecca	ربيكا
rebecca	ريبيكا
toledo	توليدو
constantinople	القسطنطينية
yahoo	ياهو
emirates	الامارات
bundesliga	البوندسليغا
hermann	هرمان
morton	مورتن
morton	مورتون
roma	روما
bangkok	بانكوك
bergen	بيرجن
bergen	برغن
bergen	بيرغن
andreas	اندرياس
cedar	سيدار
toyota	تويوتا
dhaka	دكا
christine	كرستين
christine	كريستين
tucker	توكر
tucker	تكر
augustus	اغسطس
joey	جوي
joey	جوى
moss	موس
stuttgart	شتوتغارت
gonzález	غونزاليس
percy	بيرسي
sicily	صقلية
kane	كاين
trevor	تريفور
fletcher	فليتشر
floyd	فلويد
scots	الاسكتلنديون
porto	بورتو
valencia	فالنسيا
tracy	تراسي
tracy	تريسي
tunisia	تونس
angola	انغولا
rao	راو
helena	هيلانة
helena	هيلينا
dixon	ديكسون
kuwait	kuwait
kuwait	الكويت
kuwait	كويت
fitzgerald	فيتزجيرالد
joyce	جويس
davidson	ديفيدسون
bolton	بولتون
paraguay	باراغواي
qatar	قطر
cologne	كولونيا
ming	مينج
conrad	كونراد
buck	بوك
irving	ايرفينغ
tibet	التبت
sysop	sysop
macedonian	مقدونيا
macedonian	المقدونية
macedonian	مقدوني
cameroon	الكاميرون
carson	كارسون
carson	كارسن
icelandic	ايسلندا
sophie	صوفى
sophie	صوفي
jenny	جينى
jenny	جيني
slovenian	السلوفينية
slovenian	سلوفيني
slovenian	سلوفينية
slovenian	سلوفينيا
gandhi	غاندي
rudolf	رودولف
rudolf	رودلف
midland	ميدلاند
cbc	cbc
hartford	هارتفورد
cet	cet
kay	كاي
gloria	غلوريا
gloria	جلوريا
trent	ترينت
yemen	اليمن
quinn	كوين
elena	الينا
elena	ايلينا
giuseppe	جيوسيبي
giuseppe	جوسيبي
giuseppe	جوزيبي
canberra	كانبيرا
newark	نيوارك
honduras	هندوراس
mongolia	منغوليا
nash	ناش
ricky	ريكي
shirley	شيرلي
mercedes	مرسيدس
mercedes	المرسيدس
bombay	بومباي
barack	باراك
jerome	جيروم
lindsay	لينزي
lindsay	ليندساي
honda	هوندا
ruby	روبي
mick	ميك
clyde	كلايد
shi	شي
hammond	هاموند
bucharest	بوخارست
lily	ليلي
lily	ليلى
peterson	بيترسن
albion	البيون
schmidt	شميدت
schmidt	شميت
carmen	كارمن
wesley	ويسلي
wesley	ويزلي
donna	دونا
sonic	سونيك
clarence	كلارنس
antoine	انطوان
slavic	السلافية
lopez	لوبيز
europa	يوروبا
dee	دي
verlag	verlag
lorenzo	لورينزو
lorenzo	لورنزو
nielsen	نيلسن
peruvian	البيروفية
peruvian	البيروفي
peruvian	البيرو
peruvian	بيروفي
peruvian	بيروفية
peruvian	بيرو
basque	الباسك
bangalore	بنغالور
latvian	اللاتفي
latvian	اللاتفية
latvian	لاتفيا
raj	راج
aus	aus
vic	فيك
mccarthy	مكارثي
georgetown	جورجتاون
benedict	بنديكت
benedict	بينديكت
dawson	دوسن
brett	بريت
patterson	باترسون
matthews	ماثيوس
matthews	ماثيوز
willis	ويليس
lambert	لامبرت
lambert	لامبيرت
seth	سيث
kai	كاي
bermuda	برمودا
phillies	فيليز
bryant	براينت
kolkata	كلكتا
kolkata	كالكوتا
ricardo	ريكاردو
pearson	بيرسون
gaza	غزة
shannon	شانون
whitney	ويتني
omar	عمر
taipei	تايبيه
torres	توريس
nicole	نيكول
turks	الاتراك
noah	نوح
hyde	hyde
pas	pas
brady	برادي
eleventh	eleventh
wimbledon	ويمبلدون
ronnie	روني
constantine	قسطنطين
galway	غالواي
somalia	الصومال
phillip	فيليب
eps	eps
nina	نينا
val	فال
wolfgang	وولفغانغ
wolfgang	فولفغانغ
rita	ريتا
stalin	ستالين
gustav	غوستاف
talkpage	talkpage
cal	كال
carlton	كارلتون
hassan	الحسن
hassan	حسان
dundee	دندي
clayton	كلايتون
mikhail	ميخائيل
benson	بنسون
travis	ترافيس
catalan	كتالونيا
warwick	وارويك
sanders	ساندرز
marcel	مارسيل
diane	دايان
diane	ديان
fritz	فريتز
doyle	دويل
