ash	اش
boom	بووم
boom	بوم
dust	تراب
thrown	القيت
intelligent	ذكاء
padding	حشو
agenda	اجندة
karnataka	كارناتاكا
shorts	شورت
terminology	مصطلحات
terminology	المصطلحات
tactics	التكتيكات
bunch	باقة
speculation	المضاربة
estonian	استونيا
tribune	تريبيون
permit	اسمح
ethnicity	الاثنية
heath	هيث
concerto	الكونشرتو
concerto	كونشرتو
bulk	جملة
hub	هاب
hub	هب
harmony	يام
naked	عاريا
naked	عراة
fake	وهمية
providence	بروفيدنس
troy	طروادة
ion	ايون
cluster	العنقودية
holes	فتحات
holes	الفتحات
fur	الفراء
brass	براس
tan	تان
mandatory	الزامية
sue	سو
costume	الزي
costume	زي
tin	تين
tin	تن
builder	منشئ
ain	عين
melody	ميلودي
raja	راجا
bang	بانغ
dynamics	ديناميات
limestone	الجيري
dot	دوت
fairy	جنية
fairy	الجنية
swan	سوان
petition	التماس
bend	بيند
mann	مان
cabin	كابينة
rat	رات
rat	فار
papua	بابوا
alto	التو
savage	سافج
savage	سافاج
ham	هام
beck	بيك
marina	مارينا
stade	ملعب
elephant	فيلا
ton	تون
genesis	التكوين
ultra	الترا
cruiser	كروزر
tibetan	التبت
chocolate	شوكولا
fitness	لياقته
recover	استرداد
hawk	هوك
bug	باغ
bug	باج
displacement	التشرد
sponsor	راع
ecclesiastical	الكنسية
gardner	غاردنر
blast	الانفجار
echo	ايكو
hawks	هوكس
tucker	تاكر
yield	العائد
dialects	بلهجات
wade	ويد
wade	وايد
zip	زيب
promising	واعدة
kane	كائن
outlets	منافذ
outlets	المنافذ
saga	ساجا
smoking	تدخن
smoking	يدخن
patch	باتش
mercy	ميرسي
mercy	مرسي
coral	كورال
nord	نورد
riverside	ريفرسايد
manning	مانينغ
boyd	بويد
buddy	بودي
buddy	بادي
shed	شيد
ming	مينغ
buck	باك
dell	ديل
carr	كار
booth	بوث
crane	كرين
crane	كراين
crane	كران
simulation	المحاكاة
simulation	محاكاة
asset	اصول
asset	الاصول
elderly	المسنون
corp	كورب
barn	بارن
vacant	شاغرا
challenger	تشالنجر
falcon	فالكون
reward	ثواب
tram	الترام
hastings	هاستنجز
hastings	هستنغز
hastings	هيستنجز
holly	هولي
patriarch	البطريرك
rabbit	رابيت
plaque	البلاك
summers	سامرز
rolls	رولز
liver	كب
hay	هاي
frost	فروست
bugs	البق
container	حاويات
corpus	كور
shaft	شافت
turks	تركس
noah	نواه
noah	نوا
shadows	الظل
breach	الاخلال
pyramid	هرمي
dash	داش
beaver	بيفر
spike	سبيك
spike	سبايك
klein	كلين
klein	كلاين
benson	بنسن
benson	بينسون
chassis	هيكل
