bradford	брадфорд
leon	лион
leon	леон
rachel	рейчъл
header	header
ace	ейс
penn	пен
andrews	андрюс
carol	каръл
carol	керъл
carol	карол
canterbury	кентърбъри
bailey	бейли
sixteen	sixteen
imdb	imdb
vcard	vcard
batman	батман
espn	espn
tang	танг
franco	франко
tyler	тайлър
glenn	глен
luxembourg	люксембург
duck	дък
porter	портър
memphis	мемфис
salvador	салвадор
emma	ема
emma	емма
mit	мит
gibson	гибсън
notre	notre
notre	нотр
macedonia	македония
curtis	къртис
slovakia	словакия
jeremy	джеръми
jeremy	джереми
bradley	брадли
rod	род
nacional	национал
ahmed	ахмед
edgar	едгар
ibm	ibm
rochester	рочестър
jesse	джеси
cannon	кенън
emily	емили
myspace	myspace
connor	конър
chelsea	челси
kingston	кингстън
andrea	андреа
richardson	ричардсън
nato	нато
harper	харпър
newfoundland	нюфаундленд
edmund	едмънд
ussr	ссср
css	css
cox	кокс
hugo	хюго
hugo	уго
hugo	юго
algeria	алжир
edu	еду
caroline	каролин
caroline	каролайн
caroline	керълайн
caroline	карълайн
plymouth	плимут
twentieth	twentieth
dale	дейл
seoul	сеул
lucy	люси
lucy	луси
robertson	робъртсън
milton	милтън
albany	олбъни
abdul	абдул
sudan	судан
henderson	хендерсън
marco	марко
belfast	белфаст
arctic	арктика
kurt	кърт
kurt	курт
windsor	уиндзор
monroe	монро
belgrade	белград
glory	глори
preston	престън
brad	брад
tasmania	тасмания
uruguay	уругвай
napoleon	наполеон
adrian	ейдриън
adrian	ейдриан
adrian	адриан
karen	карен
karen	керън
karen	карън
budapest	будапеща
marsh	марш
chambers	чеймбърс
ahmad	ахмад
santos	сантос
springfield	спрингфийлд
burton	бъртън
palomar	паломар
potter	потър
copyvio	copyvio
mcdonald	макдоналд
mcdonald	макдоналдс
bavaria	бавария
kumar	кумар
nineteenth	nineteenth
lyon	лайън
lyon	лион
kyle	кайл
afl	afl
brook	брук
iso	iso
jake	джейк
cornell	корнел
kenny	кени
carlo	карло
lynn	лин
joel	джоел
joel	джоуел
malcolm	малкълм
winnipeg	уинипег
bolivia	боливия
halifax	халифакс
monk	монк
monte	монте
monte	монти
fraser	фрейзър
reid	рийд
pet	pet
louisville	луисвил
hopkins	хопкинс
eds	eds
betty	бети
marion	мериън
marion	марион
jin	дзин
jin	джин
julie	джули
julie	жули
yankees	янки
yankees	янките
yankees	янкис
ludwig	лудвиг
pond	понд
lucky	лъки
lon	лон
fraud	измама
fraud	измами
lang	ланг
arcade	arcade
lecture	лекции
lecture	лекция
lecture	лекцията
copa	копа
gerald	джералд
geneva	женева
ash	аш
blade	блейд
lancaster	ланкастър
reynolds	рейнълдс
reynolds	рейнолдс
saxon	саксън
zimbabwe	зимбабве
cohen	коен
carroll	керъл
prussia	прусия
ellen	елен
ellen	еленът
ellen	елена
ellen	елън
alexandria	александрия
diana	даяна
diana	диана
cia	цру
salem	салем
wagner	уагнър
wagner	вагнер
silva	силва
derek	дерек
trinidad	тринидад
burke	бърк
willie	уили
karnataka	карнатака
heinrich	хайнрих
ethiopia	етиопия
edwin	едуин
brighton	брайтън
morrison	морисън
boeing	боинг
emmy	еми
rosa	роза
rosa	роса
burma	бирма
rica	рика
macdonald	макдоналд
atp	атп
syracuse	сиракуза
kosovo	косово
julius	юлий
julius	джулиъс
naples	неапол
sebastian	себастиан
sebastian	себастиян
barnes	барнс
martha	марта
quarters	каютата
maharashtra	махаращра
elliott	елиът
malayalam	малаялам
ulster	ълстър
randy	ранди
saxony	саксония
annie	ани
rhine	рейн
charleston	чарлстън
walt	уолт
cnn	cnn
guatemala	гватемала
dorothy	дороти
heath	хийт
richards	ричардс
theodore	теодор
theodore	тиодор
blair	блеър
janeiro	жанейро
stan	стан
stan	стен
mascot	талисман
harmony	хармъни
wwe	wwe
apollo	аполон
apollo	аполо
anton	антон
moses	моузес
moses	моисей
moses	мойсей
división	дивисион
providence	провидънс
troy	трой
troy	троя
roberto	роберто
norton	нортън
georges	жорж
jorge	хорхе
latvia	латвия
telugu	телугу
hardy	харди
nottingham	нотингам
crawford	крофърд
crawford	крауфорд
tanzania	танзания
hayes	хейс
xbox	xbox
forbes	форбс
bach	бах
claire	клеър
bruno	бруно
dylan	дилън
dylan	дилан
churchill	чърчил
thames	темза
kazakhstan	казахстан
cairo	кайро
graves	грейвс
sue	сю
logan	логън
logan	лоугън
logan	лоуган
logan	логан
erik	ерик
leicester	лестър
jessica	джесика
walsh	уолш
suffolk	съфолк
garcia	гарсия
madagascar	мадагаскар
minneapolis	минеаполис
kerry	кери
lou	лу
portsmouth	портсмут
joshua	джошуа
casey	кейси
dubai	дубай
michelle	мишел
baden	баден
clara	клара
mhz	mhz
watts	уотс
gibraltar	гибралтар
jeffrey	джефри
swift	суифт
newman	нюман
beatles	бийтълс
jacksonville	джаксънвил
sara	сара
bee	бий
czechoslovakia	чехословакия
brandon	брандън
brandon	брендън
maya	мая
imo	ммо
rhodes	роудс
itv	itv
ana	ана
jackie	джаки
fiji	фиджи
homer	хомър
homer	омир
homer	хоумър
johns	джонс
chang	ченг
chang	чанг
chad	чад
webster	уебстър
gif	gif
belarus	беларус
nascar	наскар
swan	суон
carpenter	карпентър
boris	борис
southampton	саутхемптън
maxwell	максуел
mohammad	мохамед
superman	супермен
philippe	филип
felix	феликс
greene	грийн
mann	ман
timothy	тимъти
timothy	тимоти
rafael	рафаел
georg	георг
krishna	кришна
frances	франсис
lisbon	лисабон
papua	папуа
nicolas	никола
worcester	уорчестър
winston	уинстън
llc	llc
drake	дрейк
patricia	патриша
ers	ers
garcía	гарсия
aberdeen	абърдийн
leipzig	лайпциг
santo	санто
roland	роланд
sherman	шърмън
sherman	шърман
stefan	стефан
alto	алто
thomson	томсън
zagreb	загреб
carnegie	карнеги
vernon	върнън
geoffrey	джефри
osaka	осака
beck	бек
baldwin	болдуин
sixty	sixty
venus	венера
francesco	франческо
monica	моника
deutsche	deutsche
deutsche	дойче
par	пар
pablo	пабло
aviv	авив
catalina	каталина
janet	жанет
janet	джанет
luther	лутер
luther	лутър
kiev	киев
castro	кастро
itunes	itunes
herman	хърман
herman	херман
sally	сали
rex	рекс
afghan	афганистан
vatican	ватикана
cage	кейдж
ferguson	фъргюсън
tehran	техеран
cheshire	чешър
amanda	аманда
browns	браунс
nixon	никсън
helsinki	хелзинки
bedford	бедфорд
cambodia	камбоджа
midlands	мидландс
jung	юнг
libya	либия
angela	анджела
freeman	фрийман
uci	uci
meyer	майър
meyer	майер
lima	лима
kirk	кърк
ucla	ucla
wong	уонг
hawk	хоук
ufc	ufc
chennai	ченай
dong	донг
myanmar	мианмар
chapman	чапман
riley	райли
ira	ира
ira	айра
haiti	хаити
pierce	пиърс
alma	алма
alexandra	александра
hampton	хемптън
hampton	хамптън
eva	ева
eva	ива
mickey	мики
atlético	атлетико
yuan	юан
lynch	линч
johannes	йоханес
adolf	адолф
sharon	шарън
hung	хунг
gardner	гарднър
mohammed	мохамед
reagan	рейгън
rebecca	ребека
toledo	толедо
johnston	джонстън
nat	нат