duchy	пловдивско
tang	тан
viii	виии
pace	пасе
mesa	меса
mesa	месо
tel	тел
para	пара
ernst	ернст
indo	индо
sec	сек
vale	вале
vale	вейл
fac	fac
lok	лок
trace	трейс
brass	брас
tan	тан
stern	стърн
tin	тин
spa	spa
für	für
bang	банг
stade	стад
