fernando	fernando
marcus	marcus
marcus	markus
franz	franz
isaac	isaak
isaac	isaac
isaac	ishaq
baronet	baronet
plaza	plaza
plaza	piazza
roosevelt	roosevelt
dancer	dancer
fisher	fisher
lithuania	litauen
fellowship	fellowship
eve	eva
eve	eve
slovenia	slowenien
grammy	grammy
sabha	sabha
owen	owen
liu	liu
dome	dome
epic	epic
davies	davies
allan	allan
albanian	albanien
louise	luise
louise	louise
herzegovina	herzegowina
claude	claude
cornwall	cornwall
palmer	palmer
istanbul	konstantinopel
istanbul	istanbul
calgary	calgary
stevens	stevens
yang	yang
unity	unity
lucas	lucas
lucas	lukas
armenia	armenien
interchange	interchange
hamlet	hamlet
newport	newport
westminster	westminster
julian	julian
morocco	marokko
ani	ani
ips	ip
ips	ips
giovanni	giovanni
chuck	chuck
pit	pit
garrison	garrison
denis	denis
estonia	estland
chi	chi
indie	indie
fork	fork
simpson	simpsons
simpson	simpson
edmonton	edmonton
dollar	dollars
dollar	dollar
twitter	twitter
solomon	salomon
solomon	solomon
solomon	salomo
solomon	sulaiman
solomon	salomonen
ruth	ruth
albania	albanien
indies	indies
euro	euro
cardiff	cardiff
blake	blake
frankfurt	frankfurt
galaxy	galaxy
ecuador	ecuador
georgian	georgien
copenhagen	kopenhagen
arch	arch
keys	keys
quartet	quartet
jennifer	jennifer
armstrong	armstrong
powell	powell
bros	bros
brooks	brooks
antarctica	antarktis
leslie	leslie
ellis	ellis
devon	devon
ghana	ghana
duncan	duncan
iceland	island
mph	mph
glen	glen
glen	glenn
eugene	eugene
uganda	uganda
holmes	holmes
dos	dos
surrey	surrey
gaming	gaming
amy	amy
polo	polo
linda	linda
adr	adr
zhang	zhang
fringe	fringe
orlando	orlando
henri	henri
joy	joy
julia	julia
snake	snake
nadu	nadu
bow	bow
andré	andre
andré	andré
eurovision	eurovision
doug	doug
oslo	oslo
jamie	jamie
nathan	nathan
bradford	bradford
leon	léon
leon	león
leon	leon
rachel	rachel
inspector	inspector
plains	plains
ace	ace
penn	penn
andrews	andrews
carol	carol
canterbury	canterbury
bailey	bailey
diversity	diversity
sixteen	sixteen
brussels	brüssel
imdb	imdb
batman	batman
espn	espn
tang	tang
franco	franco
tyler	tyler
glenn	glenn
luxembourg	luxemburg
duck	duck
porter	porter
memphis	memphis
salvador	salvador
emma	emma
mit	mit
gibson	gibson
notre	notre
macedonia	mazedonien
curtis	curtis
slovakia	slowakei
jeremy	jeremy
bradley	bradley
rod	rod
cdp	cdp
capitol	capitol
ferdinand	ferdinand
nacional	nacional
ahmed	ahmed
ahmed	ahmad
sin	sin
edgar	edgar
ibm	ibm
rochester	rochester
nigerian	nigeria
jesse	jesse
emily	emily
myspace	myspace
wizard	wizard
connor	connor
motors	motors
chelsea	chelsea
kingston	kingston
andrea	andrea
née	geborene
richardson	richardson
nato	nato
harper	harper
fed	fed
newfoundland	neufundland
brien	brien
edmund	edmund
ussr	udssr
ussr	sowjetunion
lat	lat
guild	guild
bones	bones
css	css
cox	cox
hugo	hugo
algeria	algerien
edu	edu
cliff	cliff
lithuanian	litauen
viii	viii
caroline	caroline
plymouth	plymouth
twentieth	twentieth
seoul	seoul
lucy	lucy
robertson	robertson
milton	milton
albany	albany
abdul	abdul
sudan	sudan
henderson	henderson
explorer	explorer
marco	marco
aids	aids
estates	estates
belfast	belfast
arctic	arktis
kurt	kurt
windsor	windsor
monroe	monroe
hearts	hearts
belgrade	belgrad
glory	glory
affiliate	affiliate
preston	preston
brad	brad
tasmania	tasmanien
uruguay	uruguay
napoleon	napoleons
napoleon	napoleon
adrian	adrian
pipe	pipe
karen	karen
budapest	budapest
compact	compact
chambers	chambers
ahmad	ahmed
ahmad	ahmad
santos	santos
springfield	springfield
kit	kit
burton	burton
inns	inns
palomar	palomar
cream	cream
potter	potter
mcdonald	mcdonald
bavaria	bayern
bavaria	bavaria
kumar	kumar
nineteenth	nineteenth
lyon	lyon
kyle	kyle
afl	afl
brook	brook
iso	iso
jake	jake
cornell	cornell
kenny	kenny
carlo	carlo
lynn	lynn
joel	joel
malcolm	malcolm
winnipeg	winnipeg
bolivia	bolivien
halifax	halifax
monk	monk
paralympics	paralympics
monte	monte
maría	maría
fraser	fraser
reid	reid
pet	pet
louisville	louisville
hopkins	hopkins
eds	eds
betty	betty
marion	marion
jin	jin
julie	julie
fbi	fbi
yankees	yankees
ludwig	ludwigs
ludwig	ludwig
lon	lon
lang	lang
dragons	dragons
copa	copa
gerald	gerald
geneva	genf
ash	ash
blade	blade
lancaster	lancaster
reynolds	reynolds
saxon	sachsen
zimbabwe	simbabwe
cohen	cohen
carroll	carroll
prussia	preußen
cherry	cherry
ellen	ellen
ellen	eilen
paradise	paradise
alexandria	alexandria
diana	diana
cia	cia
salem	salem
wagner	wagner
americas	amerika
silva	silva
derek	derek
trinidad	trinidad
burke	burke
willie	willy
willie	willie
karnataka	karnataka
heinrich	heinrich
ethiopia	äthiopien
tel	tel
edwin	edwin
raiders	raiders
brighton	brighton
para	para
morrison	morrison
div	div
ernst	ernst
boeing	boeing
emmy	emmy
indo	indo
rosa	rosa
burma	burma
burma	birma
burma	myanmar
sofia	sofia
rica	rica
macdonald	macdonald
atp	atp
syracuse	syrakus
syracuse	syracuse
kosovo	kosovo
julius	julius
naples	neapel
sebastian	sebastian
barnes	barnes
martha	martha
maharashtra	maharashtra
elliott	elliott
elliott	elliot
malayalam	malayalam
ulster	ulster
randy	randy
saxony	niedersachsen
saxony	sachsen
annie	anni
annie	annie
rhine	rheins
rhine	rhein
charleston	charleston
walt	walt
cnn	cnn
aux	aux
guatemala	guatemala
dorothy	dorothy
heath	heath
richards	richards
theodore	theodore
theodore	theodor
blair	blair
fac	fac
janeiro	janeiro
lighthouse	lighthouse
stan	stan
highland	highland
wwe	wwe
apollo	apollo
anton	anton
moses	mose
moses	moses
división	división
providence	providence
troy	troy
troy	troja
roberto	roberto
lok	lok
advocacy	advocacy
treasury	treasury
johnston	johnston
norton	norton
georges	georges
jorge	jorge
latvia	lettland
telugu	telugu
hardy	hardy
nat	nat
nottingham	nottingham
crawford	crawford
tanzania	tansania
hayes	hayes
xbox	xbox
forbes	forbes
bach	bach
claire	claire
bruno	bruno
dylan	dylan
churchill	churchill
thames	themse
thames	thames
kazakhstan	kasachstan
cairo	kairo
sue	sue
logan	logan
erik	erik
leicester	leicester
jessica	jessica
walsh	walsh
suffolk	suffolk
garcia	garcia
garcia	garcía
madagascar	madagaskar
