davies	davies
allan	allan
canyon	canyon
louise	louise
workshop	workshop
claude	claude
cornwall	cornwall
palmer	palmer
istanbul	istanbul
calgary	calgary
shock	shock
stevens	stevens
lucas	lucas
armenia	armenien
hamlet	hamlet
newport	newport
malta	maltas
malta	malta
westminster	westminster
julian	julian
morocco	marokko
morocco	marokkos
giovanni	giovanni
chuck	chuck
pit	pit
garrison	garrison
denis	denis
estonia	estland
estonia	estlands
simpson	simpsons
simpson	simpson
edmonton	edmonton
twitter	twitter
solomon	salomon
solomon	solomon
solomon	salomonøerne
ruth	ruth
albania	albanien
cardiff	cardiff
blake	blake
frankfurt	frankfurt
ecuador	ecuador
copenhagen	copenhagen
copenhagen	københavn
jennifer	jennifer
armstrong	armstrong
powell	powell
brooks	brooks
antarctica	antarktis
leslie	leslie
ellis	ellis
devon	devon
ghana	ghana
gen	gen
duncan	duncan
iceland	island
iceland	islands
glen	glen
eugene	eugene
uganda	uganda
holmes	holmes
surrey	surrey
amy	amy
amy	amys
linda	linda
zhang	zhang
orlando	orlando
henri	henri
joy	joy
julia	julia
nadu	nadu
andré	andré
eurovision	eurovision
doug	doug
oslo	oslo
jamie	jamie
nathan	nathan
bradford	bradford
leon	leon
rachel	rachel
andrews	andrews
carol	carol
canterbury	canterbury
bailey	bailey
brussels	bruxelles
imdb	imdb
batman	batman
espn	espn
franco	franco
tyler	tyler
tyler	tylers
glenn	glenn
luxembourg	luxemburg
luxembourg	luxembourg
memphis	memphis
salvador	salvador
emma	emma
gibson	gibson
notre	notre
macedonia	makedonien
curtis	curtis
slovakia	slovakiet
jeremy	jeremy
bradley	bradley
capitol	capitol
ferdinand	ferdinand
marshal	marshal
ahmed	ahmed
edgar	edgar
ibm	ibm
rochester	rochester
jesse	jesse
emily	emily
myspace	myspace
bomber	bomber
connor	connor
chelsea	chelsea
kingston	kingston
andrea	andrea
richardson	richardson
nato	nato
harper	harper
newfoundland	newfoundland
brien	brien
edmund	edmund
ussr	ussr
ussr	sovjetunionen
laser	laser
cox	cox
hugo	hugo
algeria	algeriet
edu	edu
separation	separation
cliff	cliff
caroline	caroline
plymouth	plymouth
seoul	seoul
engagement	engagement
lucy	lucy
robertson	robertson
milton	milton
albany	albany
abdul	abdul
sudan	sudan
henderson	henderson
marco	marco
belfast	belfast
arctic	arktis
kurt	kurt
windsor	windsor
monroe	monroe
belgrade	beograd
preston	preston
brad	brad
tasmania	tasmanien
uruguay	uruguay
napoleon	napoleon
adrian	adrian
karen	karen
budapest	budapest
ahmad	ahmad
santos	santos
springfield	springfield
kit	kit
burton	burton
palomar	palomar
potter	potter
mcdonald	mcdonald
bavaria	bayern
kumar	kumar
lyon	lyon
kyle	kyle
brook	brook
jake	jake
cornell	cornell
kenny	kenny
carlo	carlo
lynn	lynn
joel	joel
malcolm	malcolm
winnipeg	winnipeg
bolivia	bolivia
halifax	halifax
pub	pub
monte	monte
maría	maría
fraser	fraser
reid	reid
louisville	louisville
hopkins	hopkins
eds	eds
betty	betty
marion	marion
jin	jin
julie	julie
ludwig	ludwig
moments	moments
lang	lang
copa	copa
gerald	gerald
geneva	geneve
geneva	genève
lancaster	lancaster
reynolds	reynolds
saxon	saxon
zimbabwe	zimbabwe
cohen	cohen
carroll	carroll
mesa	mesa
prussia	preussen
paradise	paradise
alexandria	alexandria
diana	diana
cia	cia
salem	salem
wagner	wagner
silva	silva
derek	derek
trinidad	trinidad
burke	burke
willie	willie
karnataka	karnataka
heinrich	heinrich
ethiopia	etiopien
edwin	edwin
brighton	brighton
viola	viola
morrison	morrison
ernst	ernst
emmy	emmy
rosa	rosa
burma	burma
sofia	sofia
sofia	sofie
rica	rica
macdonald	macdonald
syracuse	syracuse
kosovo	kosovo
julius	julius
naples	napoli
sebastian	sebastian
barnes	barnes
martha	martha
maharashtra	maharashtra
elliott	elliott
malayalam	malayalam
ulster	ulster
randy	randy
annie	annie
rhine	rhinen
charleston	charleston
walt	walt
cnn	cnn
guatemala	guatemala
dorothy	dorothy
heath	heath
richards	richards
theodore	theodore
blair	blair
blair	blairs
fac	fac
janeiro	janeiro
stan	stan
highland	highland
harmony	harmony
apollo	apollo
anton	anton
moses	moses
providence	providence
troy	troja
roberto	roberto
johnston	johnston
norton	norton
georges	georges
jorge	jorge
latvia	letland
latvia	letlands
hardy	hardy
nat	nat
nottingham	nottingham
crawford	crawford
tanzania	tanzania
hayes	hayes
xbox	xbox
forbes	forbes
bach	bach
claire	claire
bruno	bruno
churchill	churchill
thames	themsen
kazakhstan	kasakhstan
cairo	cairo
cairo	kairo
graves	graves
sue	sue
logan	logan
erik	erik
leicester	leicester
jessica	jessica
plateau	plateau
walsh	walsh
suffolk	suffolk
garcia	garcia
garcia	garcía
madagascar	madagaskar
madagascar	madagascar
minneapolis	minneapolis
kerry	kerry
lou	lou
portsmouth	portsmouth
joshua	joshua
casey	casey
dubai	dubai
michelle	michelle
della	della
baden	baden
clara	clara
sacramento	sacramento
gibraltar	gibraltar
gibraltar	gibraltars
jeffrey	jeffrey
newman	newman
beatles	beatles
jacksonville	jacksonville
sara	sara
baltic	østersøen
baltic	baltikum
czechoslovakia	tjekkoslovakiet
brandon	brandon
maya	maya
raja	raja
griffin	griffin
rhodes	rhodos
ana	ana
jackie	jackie
fiji	fiji
algebra	algebra
homer	homer
johns	johns
chang	chang
chad	tchad
webster	webster
ashley	ashley
dot	dot
belarus	belarus
belarus	hviderusland
nascar	nascar
carpenter	carpenter
boris	boris
berry	berry
southampton	southampton
maxwell	maxwell
mohammad	mohammad
mohammad	mohammed
