stem	stamceller
ani	ani
ips	ips
alpine	alperne
centres	centres
galaxy	galaxy
arch	arch
nationalcaps	nationalcaps
seeds	fro
allmusic	allmusic
bros	bros
chronicle	chronicle
pack	pack
compromise	kompromisforslag
withdraw	tilbagetrækning
adr	atb
adr	adr
snake	snake
snake	snog
millennium	millennium
penn	penn
moderate	moderate
sixteen	sixteen
nationalgoals	nationalgoals
vcard	vcard
inches	centimeter
duck	duck
rod	rod
rod	ke
nacional	nacional
teen	teen
sheep	fåre
bigger	støre
lat	lat
bones	bones
butterfly	butterfly
viii	viii
memories	memories
dinner	dinner
explorer	explorer
pound	kilo
fourteen	fourteen
destroyer	destroyer
gathering	indsamling
pipe	pipe
marsh	marsh
chambers	chambers
pcupdate	pcupdate
cream	cream
copyvio	copyvio
nineteenth	nineteenth
thunder	thunder
monk	monk
jam	jam
pet	pet
striker	striker
lightning	lightning
fbi	fbi
suburban	forstæder
ash	ash
blade	blade
cia	cla
raiders	raiders
para	para
boxer	boxer
div	div
cites	cites
bunch	bunch
trustees	trustees
circus	circus
sec	sec
pounds	kilo
atp	atp
vale	vale
saxony	sachsen
rhine	rhin
casino	casino
elimination	elimination
wwe	wwe
división	división
troy	troy
lok	lok
dear	dear
hardy	gokke
fur	fur
lit	lit
trace	trace
streak	streak
stern	stern
bike	bike
bread	brod
nest	nest
mhz	mhz
swift	swift
bee	bee
imo	imo
für	für
rhodes	rhodes
itv	itv
rainbow	rainbow
ist	ist
bce	bce
chad	chad
rpm	rpm
swan	swan
swan	swann
