roosevelt	roosevelt
fisher	fisher
lithuania	lituania
lock	lock
eve	eva
eve	víspera
eve	eve
slovenia	eslovenia
grammy	grammy
sabha	sabha
owen	owen
liu	liu
dome	dome
epic	epic
davies	davies
allan	allan
canyon	canyon
louise	louise
louise	luisa
herzegovina	herzegovina
claude	claude
claude	claudio
claude	claudia
fortune	fortune
cornwall	cornualles
cornwall	cornwall
palmer	palmer
istanbul	estambul
calgary	calgary
shock	shock
stevens	stevens
yang	yang
unity	unity
lucas	lucas
armenia	armenia
hamlet	aldea
hamlet	hamlet
newport	newport
malta	malta
westminster	westminster
julian	julian
morocco	marruecos
ani	ani
ips	ips
giovanni	giovanni
chat	chat
herald	herald
herald	heraldo
chuck	chuck
pit	pit
garrison	garrison
denis	denis
denis	dionisio
estonia	estonia
chi	ji
chi	chi
simpson	simpson
edmonton	edmonton
twitter	twitter
solomon	salomón
ruth	ruth
grid	grid
albania	albania
cardiff	cardiff
blake	blake
frankfurt	fráncfort
frankfurt	frankfurt
frankfurt	francfort
galaxy	galaxy
ecuador	ecuador
copenhagen	copenhague
arch	arch
keys	keys
propaganda	propaganda
jennifer	jennifer
armstrong	armstrong
powell	powell
allmusic	allmusic
boulevard	boulevard
brooks	brooks
antarctica	antártica
antarctica	antártida
chronicle	chronicle
leslie	leslie
ellis	ellis
devon	devon
ghana	ghana
gen	gen
duncan	duncan
pack	pack
iceland	islandia
mph	mph
glen	cañada
glen	glen
eugene	eugenio
eugene	eugene
uganda	uganda
holmes	holmes
dos	dos
surrey	surrey
amy	amy
nights	nights
linda	linda
zhang	zhang
fringe	fringe
orlando	orlando
henri	enrique
henri	henri
joy	joy
julia	julia
snake	snake
nadu	nadu
arsenal	arsenal
bow	bow
andré	andré
serie	serie
suite	suite
doug	doug
oslo	oslo
jamie	jamie
jamie	jaime
nathan	nathan
bradford	bradford
leon	león
leon	leon
rachel	rachel
rachel	raquel
hood	hood
inspector	inspector
ace	ace
penn	penn
andrews	andrews
pin	pin
carol	carol
canterbury	canterbury
midnight	midnight
quarterback	quarterback
bailey	bailey
sixteen	sixteen
brussels	bruselas
batman	batman
espn	espn
tang	tang
franco	franco
tribal	tribal
tyler	tyler
glenn	glenn
luxembourg	luxemburgo
duck	duck
porter	porter
memphis	memphis
salvador	salvador
emma	emma
mit	mit
gibson	gibson
notre	notre
macedonia	macedonio
macedonia	macedonia
curtis	curtis
slovakia	eslovaquia
jeremy	jeremy
bradley	bradley
rod	rod
lover	lover
capitol	capitol
marshal	marshal
ahmed	ahmed
sin	sin
edgar	edgar
curriculum	curriculum
ibm	ibm
rochester	rochester
jesse	jesse
telegraph	telegraph
emily	emilia
emily	emily
catalogue	catalogue
myspace	myspace
teen	teen
quest	quest
connor	connor
motors	motors
chelsea	chelsea
kingston	kingston
andrea	andrea
richardson	richardson
nato	otan
nato	nato
harper	harper
fed	fed
newfoundland	terranova
brien	brien
edmund	edmund
ussr	urss
laser	laser
lat	lat
bones	bones
cox	cox
butterfly	butterfly
hugo	hugo
edu	edu
cliff	cliff
trick	trick
curve	curve
horizontal	horizontal
viii	viii
caroline	caroline
caroline	carolina
plymouth	plymouth
seoul	seúl
lucy	lucy
lucy	lucía
platinum	platinum
robertson	robertson
milton	milton
thriller	thriller
albany	albany
abdul	abdul
sudan	sudán
sudan	sudan
henderson	henderson
explorer	explorer
marco	marco
fusion	fusion
belfast	belfast
kurt	kurt
windsor	windsor
monroe	monroe
hearts	hearts
belgrade	belgrado
glory	glory
preston	preston
brad	brad
tasmania	tasmania
uruguay	uruguay
napoleon	napoleón
adrian	adriano
adrian	adrian
adrian	adrián
karen	karina
karen	karen
hey	hey
chambers	chambers
demo	demo
ahmad	ahmad
santos	santos
springfield	springfield
kit	kit
burton	burton
palomar	palomar
cream	cream
potter	potter
copyvio	copyvio
mcdonald	mcdonald
bavaria	baviera
kumar	kumar
mate	mate
lyon	lyon
kyle	kyle
afl	afl
brook	brook
ping	ping
jake	jake
cornell	cornell
kenny	kenny
maker	maker
inline	inline
carlo	carlo
lynn	lynn
joel	joel
jets	jets
logos	logos
malcolm	malcolm
malcolm	malcom
winnipeg	winnipeg
nose	nose
pace	pace
thunder	thunder
bolivia	bolivia
halifax	halifax
pub	pub
monte	monte
wireless	wireless
fraser	fraser
jam	jam
idol	idol
reid	reid
pet	pet
louisville	louisville
hopkins	hopkins
eds	eds
betty	betty
marion	marion
export	export
lightning	lightning
jin	jin
julie	julie
fbi	fbi
yankees	yankees
ludwig	ludwig
ludwig	luis
pond	pond
moments	moments
lon	lon
speedway	speedway
toy	toy
lang	lang
copa	copa
patron	patron
gerald	gerald
geneva	génova
geneva	ginebra
ash	ash
blade	blade
array	array
boom	boom
lancaster	lancaster
reynolds	reynolds
saxon	saxon
zimbabwe	zimbabue
zimbabwe	zimbabwe
cohen	cohen
carroll	carroll
mesa	mesa
prussia	prusia
cherry	cherry
ellen	ellen
ellen	elena
paradise	paradise
alexandria	alejandría
diana	diana
cia	cia
cia	cla
rankings	rankings
salem	salem
wagner	wagner
americas	américas
instructor	instructor
tomorrow	tomorrow
scouts	scouts
silva	silva
derek	derek
agenda	agenda
terror	terror
trinidad	trinidad
burke	burke
willie	willie
karnataka	karnataka
heinrich	heinrich
ethiopia	etiopía
tel	tel
shorts	shorts
edwin	edwin
raiders	raiders
brighton	brighton
viola	viola
morrison	morrison
boxer	boxer
div	div
ernst	ernesto
emmy	emmy
indo	indo
rosa	rosa
marines	marines
bacteria	bacteria
circus	circus
burma	birmania
pastor	pastor
sofia	sofia
sofia	sofía
tribune	tribune
rica	rica
macdonald	macdonald
atp	atp
syracuse	syracuse
kosovo	kosovo
julius	julio
sebastian	sebastián
sebastian	sebastian
barnes	barnes
martha	marta
martha	martha
maharashtra	maharashtra
elliott	elliott
brigadier	brigadier
malayalam	malayalam
icon	icon
genes	genes
vale	vale
randy	randy
convoy	convoy
annie	anita
annie	annie
mineral	mineral
charleston	charleston
walt	walt
cnn	cnn
tonight	tonight
casino	casino
guatemala	guatemala
dorothy	dorothy
heath	heath
richards	richards
theodore	theodore
theodore	teodoro
blair	blair
fac	fac
janeiro	janeiro
bits	bits
stan	stan
highland	highland
hub	hub
harmony	harmony
wwe	wwe
apollo	apolo
apollo	apollo
anton	anton
moses	moses
providence	providence
tenor	tenor
pocket	pocket
troy	troy
ion	ion
roberto	roberto
lok	lok
johnston	johnston
norton	norton
cluster	cluster
georges	georges
roller	roller
holdings	holdings
jorge	jorge
chip	chip
latvia	letonia
telugu	telugu
blogs	blogs
hardy	hardy
nat	nat
ritual	ritual
trace	trace
nottingham	nottingham
touchdowns	touchdowns
crawford	crawford
tanzania	tanzania
hayes	hayes
xbox	xbox
likes	likes
forbes	forbes
brass	brass
bach	bach
alias	alias
claire	claire
bruno	bruno
dylan	dylan
churchill	churchill
tan	tan
kazakhstan	kazajistán
kazakhstan	kazajstán
bots	bots
prof	prof
skull	skull
bet	bet
inventor	inventor
cairo	cairo
graves	graves
logan	logan
erik	erik
erik	erick
leicester	leicester
jessica	jessica
walsh	walsh
exterior	exterior
bike	bike
suffolk	suffolk
tin	tin
garcia	garcía
garcia	garcia
madagascar	madagascar
minneapolis	minneapolis
kerry	kerry
arrow	arrow
lou	lou
rifles	rifles
slam	slam
portsmouth	portsmouth
miscellany	miscellany
joshua	joshua
joshua	josué
casey	casey
ain	ain
dubai	dubái
dubai	dubai
michelle	michelle
della	della
baden	baden
clara	clara
sacramento	sacramento
mhz	mhz
spa	spa
watts	watts
gibraltar	gibraltar
melody	melody
jeffrey	jeffrey
swift	swift
newman	newman
beatles	beatles
jacksonville	jacksonville
sara	sara
bee	bee
czechoslovakia	checoslovaquia
brandon	brandon
