iso	आईएसओ
jake	jake
jake	जेक
cornell	कॉर्नेल
kenny	केनी
carlo	कार्लो
joel	जोएल
malcolm	मैल्कम
winnipeg	विन्निपेग
bolivia	बोलिविया
bolivia	बोलीविया
monte	मोंटे
fraser	फ्रेज़र
jam	jam
hopkins	हॉपकिंस
eds	eds
betty	बेट्टी
jin	जिन
julie	जूली
fbi	एफबीआई
yankees	यांकीज़
ludwig	लुडविग
moments	moments
lucky	lucky
lang	लंग
lang	लैंग
copa	कोपा
gerald	जेराल्ड
geneva	जिनेवा
geneva	जेनेवा
reynolds	रेनॉल्ड्स
zimbabwe	जिम्बाब्वे
zimbabwe	ज़िम्बाब्वे
cohen	कोहेन
ellen	एलेन
alexandria	एलेक्जेंड्रिया
diana	डायना
cia	cia
cia	सीआईए
salem	सलेम
wagner	वेगनर
silva	सिल्वा
derek	डेरेक
trinidad	त्रिनिदाद
burke	बर्क
burke	बुर्के
willie	विली
ethiopia	इथियोपिया
edwin	एडविन
brighton	ब्राइटन
morrison	मॉरिसन
div	div
ernst	अर्नस्ट
boeing	बोइंग
emmy	एमी
rosa	रोज़ा
rosa	रोजा
burma	बर्मा
sofia	सोफिया
rica	रिका
atp	एटीपी
kosovo	कोसोवो
julius	जूलियस
naples	नेपल्स
sebastian	सेबेस्टियन
martha	मार्था
maharashtra	महाराष्ट्र
maharashtra	maharashtra
malayalam	मलयालम
randy	रैंडी
saxony	सैक्सोनी
annie	एनी
rhine	राइन
charleston	चार्ल्सटन
walt	वॉल्ट
cnn	सीएनएन
guatemala	ग्वाटेमाला
dorothy	डोरोथी
heath	झाड़
richards	रिचर्ड्स
theodore	थियोडोर
blair	ब्लेयर
janeiro	जेनेरो
concerto	concerto
stan	स्टेन
wwe	wwe
apollo	अपोलो
anton	एंटोन
moses	मूसा
troy	ट्रॉय
roberto	रॉबर्टो
norton	नॉर्टन
georges	जॉर्जेस
jorge	जोर्ज
vfd	vfd
rican	rican
latvia	लातविया
latvia	लातवियाई
telugu	तेलुगू
telugu	तेलुगु
hardy	हार्डी
nat	नैट
nat	nat
nottingham	nottingham
crawford	क्रॉफर्ड
yugoslav	यूगोस्लाव
tanzania	तंजानिया
motto	motto
hayes	हेज़
xbox	एक्सबॉक्स
forbes	फोर्ब्स
bach	बच
claire	क्लेयर
bruno	ब्रूनो
dylan	डायलन
dylan	डिलन
churchill	चर्चिल
thames	टेम्स
kazakhstan	क़ाज़ाक़स्तान
cairo	कैरो
cairo	काहिरा
cairo	कायरो
graves	क़ब्रों
sue	सू
sue	मुकदमा
logan	लोगन
leicester	लीसेस्टर
jessica	जेसिका
walsh	वाल्श
suffolk	सफ़क
garcia	गार्सिया
madagascar	मेडागास्कर
minneapolis	मिनियापोलिस
kerry	केरी
lou	लू
joshua	जोशुआ
casey	केसी
ain	ऐन
ain	ain
dubai	दुबई
michelle	मिशेल
della	देला
clara	क्लारा
mhz	mhz
spa	spa
gibraltar	जिब्राल्टर
jeffrey	जेफरी
swift	swift
statlabel	statlabel
newman	न्युमैन
beatles	बीटल्स
sara	sara
sara	सारा
lifestyle	lifestyle
czechoslovakia	चेकोस्लोवाकिया
brandon	ब्रैंडन
maya	माया
imo	imo
raja	raja
raja	राजा
itv	आईटीवी
ana	आना
ana	ana
ist	ist
jackie	जैकी
fiji	फिजी
homer	होमर
johns	जॉन्स
bce	bce
chang	chang
chad	चाड
chad	कैंडल
chad	chad
webster	वेबस्टर
ashley	एशले
gif	gif
belarus	बेलारूस
nascar	nascar
diploma	diploma
boris	बोरिस
app	app
maxwell	मैक्सवेल
superman	सुपरमैन
felix	फेलिक्स
montenegro	मोंटेनेग्रो
mann	मन
timothy	टिमोथी
rafael	राफेल
krishna	krishna
krishna	कृष्ण
krishna	कृष्णा
lisbon	लिस्बन
darwin	डार्विन
papua	पापुआ
nicolas	निकोलस
madonna	मैडोना
worcester	worcester
winston	विंस्टन
llc	llc
nrhp	nrhp
drake	ड्रेक
patricia	पेट्रीसिया
aberdeen	एबरडीन
reds	लाल
leipzig	लिपजिग
santo	सेंटो
sherman	शरमन
alto	आल्टो
carnegie	कार्नेगी
vernon	vernon
osaka	ओसाका
beck	बेक
marina	मरीना
monica	मोनिका
pablo	पाब्लो
janet	जेनेट
luther	लूथर
alberto	अल्बर्टो
kiev	कीव
vista	विस्टा
castro	कास्त्रो
wei	वेई
itunes	itunes
sally	सैली
rex	रेक्स
mvp	mvp
vatican	वेटिकन
ferguson	फर्ग्यूसन
tehran	तेहरान
cheshire	चेशायर
amanda	अमांडा
browns	ब्राउन्स
browns	भूरा
nixon	निक्सन
helsinki	हेलसिंकी
bedford	bedford
cambodia	कम्बोडिया
cambodia	कंबोडिया
jung	जुंग
jung	जंग
libya	लीबिया
angela	एंजेला
android	android
freeman	फ्रीमैन
csd	csd
carey	कैरी
lima	लीमा
kirk	किर्क
ucla	ucla
wong	वोंग
cumberland	कम्बरलैंड
ufc	ufc
chennai	चेन्नई
chennai	चेन्नै
dong	डांग
myanmar	म्यांमार
kannada	कन्नड़
riley	रिले
ira	ira
haiti	हैती
pierce	पियर्स
alexandra	एलेक्जेंड्रा
hampton	हैम्पटन
eva	ईवा
eva	एवा
mickey	मिकी
atlético	एटलेटिको
yuan	युआन
johannes	योहानेस
adolf	एडोल्फ
sharon	शेरोन
gardner	गार्डनर
rebecca	रेबेका
toledo	टोलेडो
constantinople	कुस्तुंतुनिया
yahoo	yahoo
yahoo	याहू
emirates	अमीरात
jenkins	जेनकींस
omaha	ओमाहा
hermann	हर्मन
morton	मॉर्टन
bangkok	बैंकाक
bangkok	बैंकॉक
lankan	lankan
toyota	टोयोटा
coleman	कोलमैन
dhaka	ढाका
christine	क्रिस्टीन
christine	क्रिस्टिन
tucker	टकर
viscount	viscount
joey	जॉय
wade	वेड
gonzález	gonzález
percy	पर्सी
sicily	सिसिली
zip	zip
lin	लिन
kane	केन
trevor	ट्रेवर
fletcher	फ्लेचर
scots	स्कॉट्स
archdiocese	archdiocese
porto	पोर्टो
valencia	वालेंसिया
subfamily	subfamily
tracy	ट्रेसी
andhra	आन्ध्र
andhra	आंध्र
tunisia	ट्यूनीशिया
angola	अंगोला
rao	राव
xavier	जेवियर
helena	हेलेना
dixon	डिक्सन
kuwait	कुवैत
nsw	nsw
riverside	riverside
shane	शेन
fitzgerald	fitzgerald
lópez	लोपेज़
belle	बेल
belle	बेले
davidson	डेविडसन
bolton	बोल्टन
manning	मैनिंग
boyd	boyd
paraguay	पैराग्वे
dodgers	डॉजर्स
qatar	कतर
qatar	क़तर
iucn	आईयूसीएन
norwich	norwich
ming	मिंग
tibet	तिब्बती
tibet	तिब्बत
sysop	sysop
caesar	सीज़र
unesco	यूनेस्को
unesco	युनेस्को
cameroon	कैमरून
carson	कार्सन
sophie	सोफी
jenny	जेनी
gandhi	गाँधी
gandhi	gandhi
gandhi	गांधी
middlesex	मिडलसेक्स
rudolf	रुडॉल्फ
sutton	सटन
ups	ups
que	que
exeter	एक्सेटर
kay	कय
kay	काय
lance	lance
gloria	ग्लोरिया
trent	ट्रेंट
yemen	यमन
quinn	क्विन
elena	एलेना
giuseppe	ग्यूसेप
rca	आरसीए
canberra	कैनबरा
newark	न्यूर्क
honduras	होंडुरास
pbs	pbs
mongolia	मंगोलिया
mongolia	अंगोला
mongolia	मंगोल
nash	nash
ricky	रिकी
shirley	शर्ली
mercedes	मर्सिडीज
bombay	बॉम्बे
bombay	बम्बई
bombay	bombay
barack	बराक
jerome	जेरोम
lindsay	लिंडसे
johan	जोहान
leone	लिओन
honda	होंडा
mick	मिक
clyde	क्लाइड
shi	shi
hannah	हन्ना
hammond	हैमंड
bucharest	बुखारेस्ट
peterson	पीटरसन
schmidt	श्मिट
hyderabad	हैदराबादी
hyderabad	हैदराबाद
carmen	कार्मेन
erie	erie
kashmir	कश्मीरी
kashmir	कश्मीर
kashmir	कश्मीरियों
kashmir	काश्मीर
wesley	वेस्ले
arlington	आर्लिंगटन
sterling	स्टर्लिंग
donna	डोना
katherine	कैथरीन
antoine	एंटोनी
derbyshire	डर्बीशायर
lopez	लोपेज
lopez	लोपेज़
intel	इंटेल
winchester	विनचेस्टर
buddha	बुद्ध
dee	dee
hank	हांक
verlag	verlag
hastings	हास्टिंग्स
taxa	taxa
holly	होली
rey	rey
lorenzo	lorenzo
nielsen	nielsen
basque	बास्क
bangalore	बैंगलोर
bangalore	बंगलौर
raj	raj
coventry	coventry
vic	विक
mccarthy	मैकार्थी
benedict	बेनेडिक्ट
commodore	commodore
dawson	डाउसन
emi	ईएमआई
emi	emi
brett	ब्रेट
patterson	पैटरसन
