integral	इंटीग्रल
modes	मोड्स
servant	बन्दा
maker	मेकर
inline	इनलाइन
logos	लोगो
thunder	थंडर
toll	टोल
pub	पब
wireless	वायरलेस
formats	फ़ॉर्मेट
jam	जैम
chicken	चिकन
idol	आइडल
striker	स्ट्राइकर
logical	लॉजिकल
conjunction	कनेक्शन
interim	अंतरिम
lucky	लकी
speedway	स्पीडवे
regiments	regiments
lecture	लेक्चर
dragons	ड्रेगन
module	मॉड्यूल
commands	कमांड्स
commands	कमांड
trend	रुझान
trend	प्रवृत्ति
trend	ट्रेंड
ash	ash
ash	ऐश
blade	ब्लेड
array	ऐरे
sockpuppet	sockpuppet
padding	पैडिंग
screenwriter	screenwriter
provision	रोज़ी
unfree	unfree
associates	शरीक
shorts	शॉर्ट्स
drives	ड्राइव
para	पारा
para	पैरा
innocent	innocent
rapper	rapper
indo	हिन्द
feminist	feminist
landmarks	लैंडमार्क
rivalry	फंसने
prevention	निवारण
sec	सेक
permit	परमिट
offense	ठोकर
vale	वेल
crashed	क्रैश
tune	tune
bulk	बल्क
entrepreneur	उद्यमियों
entrepreneur	entrepreneur
entrepreneur	उद्देश्यों
fake	fake
sad	sad
dear	dear
darkness	उजाला
cooking	कुकिंग
trainer	trainer
scorer	स्कोरर
stamp	स्टैम्प
lit	lit
protagonist	समर्थक
bag	bag
tan	तन
myth	मिथक
armament	armament
precedent	यही
cameras	कैमरा
fires	फ़ायर
builder	बिल्डर
subway	सबवे
arrow	बाणों
miscellany	miscellany
convince	मनाना
audiences	ऑडियंस
unencyclopedic	unencyclopedic
tracking	ट्रैकिंग
elaborate	जटिल
elaborate	अलंकृत
swift	स्विफ्ट
vandal	vandal
prairie	प्रेयरी
bend	बेंड
acclaimed	acclaimed
bassist	bassist
voluntary	voluntary
crowned	पहनाया
quit	बाहर
chef	शेफ़
shirt	shirt
guides	मार्गदर्शिका
savage	वहशी
savage	savage
analog	एनालॉग
salmon	सामन
adminship	adminship
airborne	एयरबोर्न
tension	टेंशन
lesbian	लेस्बियन
realm	फ्रेम
consolidated	संचित
battalions	battalions
receptor	receptor
lineup	लाइनअप
ultra	अल्ट्रा
eng	eng
pos	pos
bye	bye
recover	रिकवर
servants	बन्दों
hawk	हॉक
rector	रेक्टर
mud	mud
decree	डिक्री
careers	कैरियर
lynch	लिंच
ecclesiastical	ecclesiastical
mandate	आदेश
dish	डिश
gymnastics	जिमनास्टिक्स
harassment	छल
bore	bore
luxury	लक्ज़री
reviewers	reviewers
chronicles	क्रॉनिकल्स
harsh	harsh
sake	sake
stake	हिस्सेदारी
unassessed	unassessed
torture	टॉर्चर
moss	मॉस
parody	व्यंग्य
armored	कराया
factual	तथ्यात्मक
outlets	आउटलेट
airways	यातायात
subspecies	subspecies
lone	लोन
slide	स्लाइड
rowing	rowing
binary	शब्दकोष
regent	रीजेंट
highlight	हाइलाइट
dock	डॉक
rapids	रैपिड्स
papal	papal
shed	शेड
cologne	कोलोन
hang	हैंग
dell	डेल
bells	बेल्स
composite	घटक
apostolic	अपोस्टोलिक
userpage	userpage
bypass	बायपास
phantom	फैंटम
din	दीन
latitude	शर
keeper	कीपर
fixing	फिक्सिंग
asset	एसेट
boot	बूट
commentator	कमेंटेटर
poly	पॉली
poly	बहु
handbook	हैंडबुक
bare	bare
bride	बहू
automotive	ऑटोमोटिव
heating	हीटिंग
lunch	लंच
cups	cups
hardcore	हार्डकोर
lily	लिली
visa	वीजा
visa	वीज़ा
mainspace	mainspace
commit	कमिट
sonic	सोनिक
facto	facto
wingspan	wingspan
gateway	गेटवे
ivory	आइवरी
interference	इंटरफेस
crews	क्रू
trivia	ट्रिविया
wives	पत्नियों
plaque	प्लैक
screening	स्क्रीनिंग
mob	mob
reunion	रवि
