macho	macho
steven	steven
bach	bach
viña	viña
murray	murray
mhz	mhz
jordi	jordi
jordi	george
girls	girls
tennessee	tennessee
mariana	mariana
turco	turco
mineral	mineral
castellana	castellana
integra	integra
alabama	alabama
krai	krai
criminal	criminal
ginebra	gin
ginebra	geneva
juveniles	juveniles
rick	rick
berlin	berlin
eddie	eddie
claudia	claudia
claudia	claude
apple	apple
benjamin	benjamin
serena	serena
unam	unam
bryan	bryan
petersburgo	petersburg
gosse	gosse
palestina	palestine
palestina	palestinian
maryland	maryland
arm	arm
masters	masters
dream	dream
space	space
tervuren	tervuren
linda	linda
genes	genes
genes	gene
nicolas	nicolas
perón	perón
pepe	jiminy
pepe	pepe
alice	alice
maurice	maurice
cecilia	cecile
cecilia	cecilia
marte	mars
loco	loco
harrison	harrison
stewart	stewart
argelia	algiers
argelia	algerian
argelia	algeria
sound	sound
parker	parker
xavier	xavier
chipre	cyprus
guy	guy
songs	songs
thys	thys
inés	inés
alfa	alfa
caudal	caudal
ann	ann
edgar	edgar
barry	barry
manchester	manchester
beatles	beatles
higgins	higgins
receptor	receptor
xbox	xbox
force	force
ken	ken
lgbt	lgbt
centre	centre
pacheco	pacheco
abraham	abraham
lost	lost
turín	torino
turín	turin
sídney	sydney
land	land
figueroa	figueroa
bus	bus
mini	mini
master	master
let	let
robinson	robinson
renault	renault
raymond	raymond
jerry	jerry
heinrich	heinrich
arabia	arabia
cuesta	cuesta
dei	dei
robot	robot
sra	sra
cárdenas	cárdenas
roland	roland
gold	gold
fred	fred
rob	rob
chaco	chaco
site	site
wright	wright
llano	llano
huerta	huerta
chiapas	chiapas
lucio	lucio
lucio	lucius
montenegro	montenegro
emma	emma
terry	terry
lobos	lobos
century	century
malta	malta
turner	turner
vidal	vidal
luxemburgo	luxemburg
luxemburgo	luxembourg
prusia	prussia
prusia	prussian
cross	cross
ron	ron
estrada	estrada
phoenix	phoenix
maine	maine
varsovia	warsaw
graham	graham
renfe	renfe
sucre	sucre
baltimore	baltimore
stars	stars
norman	norman
humberto	humberto
humberto	humbert
humberto	umberto
humberto	hubert
aurora	aurora
ámsterdam	amsterdam
potosí	potosí
propaganda	propaganda
thompson	thompson
jay	jay
singapur	singapore
bank	bank
hamburgo	hamburg
pereira	pereira
fiat	fiat
correa	correa
episcopal	episcopal
concacaf	concacaf
cbs	cbs
jamaica	jamaica
jamaica	jamaican
roll	roll
paco	paco
matías	mathias
matías	matías
matías	matthias
nancy	nancy
crimea	crimea
crimea	crimean
pokémon	pokémon
stanley	stanley
rin	rin
rin	rhine
legend	legend
seattle	seattle
donald	donald
rincón	rincon
rincón	rincón
jacob	jacob
hms	hms
arequipa	arequipa
maldonado	maldonado
gov	gov
homer	homer
liverpool	liverpool
darío	darío
imdb	imdb
lituania	lithuanian
lituania	lithuania
tommy	tommy
euphorbia	euphorbia
soprano	soprano
now	now
informa	informa
sonic	sonic
semifinal	semifinal
manhattan	manhattan
cia	cia
baden	baden
tabasco	tabasco
bros	bros
bobby	bobby
lugo	lugo
nasa	nasa
gilbert	gilbert
escobar	escobar
campbell	campbell
danny	danny
arsenal	arsenal
nigeria	nigerian
nigeria	nigeria
gibraltar	gibraltar
complutense	complutense
márquez	márquez
márquez	marquez
place	place
cleveland	cleveland
borgoña	burgundy
beta	beta
charlotte	charlotte
azteca	azteca
boeing	boeing
ama	ama
arnold	arnold
calvo	calvo
barbara	barbara
detective	detective
mónica	mónica
budapest	budapest
madison	madison
leftarm	leftarm
estero	estero
merced	merced
rivas	rivas
tve	tve
note	note
carrillo	carrillo
valdivia	valdivia
luisiana	louisiana
televisa	televisa
gases	gases
basket	basket
demo	demo
kent	kent
larry	larry
prince	prince
giuseppe	giuseppe
pura	pura
track	track
honda	honda
román	román
alvarado	alvarado
ibáñez	ibáñez
shows	shows
name	name
belén	bethlehem
belén	belen
rangers	rangers
herbert	herbert
vaticano	vatican
cooper	cooper
duero	douro
duero	duero
august	august
summer	summer
col	col
ludwig	ludwig
velázquez	velázquez
velázquez	velasquez
túnez	tunisia
túnez	tunisian
túnez	tunis
magic	magic
wood	wood
coronado	coronado
robles	robles
philippe	philippe
concha	concha
warren	warren
elías	elías
elías	elijah
elías	elias
ltd	ltd
studio	studio
antoine	antoine
guipúzcoa	guipúzcoa
hits	hits
tenor	tenor
leipzig	leipzig
apolo	apollo
radar	radar
wagner	wagner
television	television
finca	finca
edwards	edwards
roman	roman
oliva	oliva
escape	escape
shakespeare	shakespeare
marín	marin
marín	marín
für	für
eugenia	eugenia
cap	cap
fresco	fresco
age	age
abu	abu
lázaro	lázaro
lázaro	lazarus
wolf	wolf
rita	rita
uss	uss
kiev	kiev
paloma	paloma
ira	ira
etiopía	ethiopia
dick	dick
jefferson	jefferson
celeste	celeste
palermo	palermo
bond	bond
blood	blood
pink	pink
blas	bert
blas	blas
blas	blaise
bull	bull
ayala	ayala
sacramento	sacramento
neil	neil
libia	libyan
libia	libya
collins	collins
silvia	sylvia
silvia	sylvie
silvia	silvia
emi	emi
normandía	normandie
normandía	normandy
prieto	prieto
teruel	teruel
nat	nat
via	via
camp	camp
rivadavia	rivadavia
sri	sri
cook	cook
eeuu	usa
marquesa	marquesa
denis	denis
vitoria	vitoria
estonia	estonian
estonia	estonia
helena	helena
helena	helen
gabriela	gabriella
gabriela	gabriela
radios	radios
linares	linares
side	side
lunar	lunar
sud	sud
ferrari	ferrari
callao	callao
brooklyn	brooklyn
taekwondo	taekwondo
gard	gard
evans	evans
georg	georg
adrián	adrian
head	head
gallo	gallo
ivan	ivan
matthew	matthew
nbc	nbc
susana	susannah
susana	susana
susana	suzanne
susana	susanna
susana	susan
américas	americas
square	square
amy	amy
autovía	autovía
dean	dean
leonor	leonor
videoclip	videoclip
films	films
banca	banca
stuttgart	stuttgart
eco	eco
acosta	acosta
class	class
morelos	morelos
leal	leal
guido	guido
lloyd	lloyd
jennifer	jennifer
marinas	marinas
lorca	lorca
serra	serra
marcel	marcel
dylan	dylan
harold	harold
almagro	almagro
brothers	brothers
potter	potter
robo	robo
angola	angola
angola	angolan
hudson	hudson
pampa	pampa
pinto	pinto
cauca	cauca
connecticut	connecticut
saboya	savoy
morris	morris
paolo	paolo
guevara	guevara
compostela	compostela
cayo	cayo
melbourne	melbourne
michelle	michelle
tomas	tomas
tomas	thomas
blake	blake
mónaco	monaco
ontario	ontario
chocolate	chocolate
berkeley	berkeley
jacobo	jacob
jacobo	james
jacobo	jacobo
sul	sul
val	val
mono	mono
zero	zero
kurt	kurt
hardware	hardware
test	test
gaspar	gaspar
institut	institut
kate	kate
luigi	luigi
afc	afc
albania	albania
costarricense	costarricense
seúl	seoul
wii	wii
eslovenia	slovenia
eslovenia	slovenian
soccerway	soccerway
mitre	mitre
watson	watson
anglo	anglo
philadelphia	philadelphia
bart	bart
habsburgo	habsburg
perciformes	perciformes
camilo	camillo
camilo	camilo
ram	ram
michoacán	michoacán
espinosa	espinosa
dante	dante
ted	ted
myspace	myspace
utc+	utc+
cover	cover
dennis	dennis
hunter	hunter
box	box
honoris	honoris
ola	ola
