विराट	virat
ईस्टवुड	eastwood
मैक्सिको	mexico
नरसिंह	narasimha
विजयनगर	vijayanagar
ईस्टर	easter
जेरिको	jericho
टैगोर	tagore
जार्ज	george
कौर	kaur
मिनी	mini
सौरभ	saurabh
फेसबुक	facebook
जैक्सन	jackson
केप	cape
बम्बई	bombay
एयरबस	airbus
सलीम	salim
डेविस	davis
पेरू	peru
यूनिक्स	unix
पाण्डेय	pandey
अलास्का	alaska
रेड्डी	reddy
दामोदर	damodar
बंगला	bangla
इराक़	iraq
फारस	persia
अनिरुद्ध	anirudh
खां	khan
एलिजाबेथ	elizabeth
डिएगो	diego
पैट्रिक	patrick
विक्टर	victor
भुवनेश्वर	bhubaneswar
भारद्वाज	bhardwaj
रामचंद्र	ramchandra
रामचंद्र	ramachandra
वार्नर	warner
लेबनान	lebanon
भट्टाचार्य	bhattacharya
साहनी	sahni
स्वीडिश	swedish
एडम्स	adams
ट्विटर	twitter
जेरी	jerry
मॉनमाउथ	monmouth
अमृता	amrita
गेट्स	gates
डैनियल	daniel
फिलाडेल्फिया	philadelphia
अपोलो	apollo
एफबीआई	fbi
कैमरून	cameroon
संतोष	santosh
रोलिंग	rolling
रोलिंग	rowling
टेरी	terry
सउदी	saudis
फतेहपुर	fatehpur
दशरथ	dasharatha
पोर्टलैंड	portland
फ्रैंकफर्ट	frankfurt
स्विट्ज़रलैंड	switzerland
मुजफ्फरपुर	muzaffarpur
वियना	vienna
उपनिषद्	upanishads
सीनियर	sr
नानक	nanak
हर्ष	harsh
फिनलैंड	finland
टिम	tim
ओवेन	owen
चित्रकूट	chitrakoot
राखी	rakhi
एंड्रयू	andrew
सूर्यवंशी	suryavanshi
मल्होत्रा	malhotra
कुवैत	kuwait
चेतन	chetan
विनय	vinay
पतंजलि	patanjali
लिवरपूल	liverpool
ऐन	ann
मकर	capricorn
एंडी	andy
शेफ़ील्ड	sheffield
केदारनाथ	kedarnath
कपिल	kapila
कपिल	kapil
चाणक्य	chanakya
पाटिल	patil
माधोपुर	madhopur
अरुणा	aruna
भवानी	bhawani
अम्बेडकर	ambedkar
बैंगलोर	bangalore
वेदांत	vedanta
मैट	matt
अलाउद्दीन	alauddin
सोनिया	sonia
रोमानिया	romania
ग्रोवर	grover
मेघालय	meghalaya
इवान	ivan
नेल्सन	nelson
लुइस	luis
क्लैप्टन	clapton
डगलस	douglas
चालुक्य	chalukya
चालुक्य	chalukyas
एलेक्स	alex
मेनन	menon
गोदावरी	godavari
मौलाना	maulana
रामचन्द्र	ramchandra
रामचन्द्र	ramachandra
जमशेदपुर	jamshedpur
अल्जीरिया	algeria
सावित्री	savitri
क्रिस्टोफर	christopher
किरन	kiran
मॉरिसन	morrison
जोली	jolie
सुमन	suman
अमित	amit
स्विट्जरलैंड	switzerland
अजीत	ajit
बेंजामिन	benjamin
एंडरसन	anderson
गिल	gill
बॉम्बे	bombay
मिशिगन	michigan
डकोटा	dakota
पीट	pete
पीट	piet
बॉबी	bobby
बिशप	bishop
एथेंस	athens
जौनपुर	jaunpur
यूट्यूब	youtube
मारुति	maruti
श्रुति	shruti
शुक्ला	shukla
इब्न	ibn
किम	kim
मैसाचुसेट्स	massachusetts
ताजिकिस्तान	tajikistan
डार्विन	darwin
जुडी	judy
खुर्द	khurd
एयरवेज	airways
रहीम	rahim
वॉल्ट	walt
आमिर	amir
आमिर	aamir
उमर	omar
मिलर	miller
ललिता	lalitha
ललिता	lalita
रज़ा	raza
जोन	joan
यूक्रेन	ukraine
वाइल्ड	wilde
निसान	nissan
माथुर	mathur
बेकर	baker
बेकर	becker
वृंदावन	vrindavan
नागार्जुन	nagarjuna
यूएसए	usa
भटनागर	bhatnagar
ब्रह्मपुत्र	brahmaputra
रामदेव	ramdev
निर्मल	nirmal
गल्फ	gulf
अंटार्कटिक	antarctica
डैनी	danny
द्वारका	dwarka
एडम	adam
लियोन	leon
एमटीवी	mtv
एवरेस्ट	everest
पीयूष	piyush
शाहजहाँ	shahjahan
ऋषिकेश	rishikesh
स्विफ्ट	swift
माघ	magha
माघ	magh
नेटस्केप	netscape
रॉबिन	robin
बीजिंग	beijing
सावरकर	savarkar
कैलिफ़ोर्निया	california
कैलगरी	calgary
जावेद	jawed
जावेद	javed
स्पेंसर	spencer
वेदव्यास	vyasa
तुर्कमेनिस्तान	turkmenistan
रॉबर्ट्स	roberts
राँची	ranchi
डेनिस	denise
डेनिस	dennis
डेनिस	denis
जोएल	joel
गांधीजी	gandhiji
शंघाई	shanghai
जहांगीर	jahangir
राजेंद्र	rajendra
विश्वकर्मा	vishwakarma
नालंदा	nalanda
श्रीनिवास	srinivasa
मिसौरी	missouri
मारी	marie
मारी	mari
आमेर	amer
दारा	darius
दारा	dara
एलेन	ellen
एस्टन	aston
दुबे	dubey
मूसा	moses
मूसा	musa
मूसा	moosa
पिंक	pink
सत्येन्द्र	satyendra
बैरी	barry
बैरी	antagonist
राजन	rajan
जीप	jeep
मैथ्यू	matthew
अंडमान	andaman
मिर्ज़ा	mirza
मिर्ज़ा	mirzapur
उषा	usha
ब्रायंट	bryant
गैरी	garry
गैरी	gary
कुश	kush
साइमन	simon
चैत्र	chaitra
हक	huck
हक	haque
हक	haq
नेहरु	nehru
प्राणायाम	pranayama
महेन्द्र	mahendra
स्टारबक्स	starbucks
जॉर्डन	jordan
मनीष	manish
बीजापुर	bijapur
वृन्दावन	vrindavan
महासागरीय	oceania
रघुनाथ	raghunath
सहारनपुर	saharanpur
सुधीर	sudhir
एव	ave
एव	ew
एव	av
सामी	sami
तिरुपति	tirupati
विश्वामित्र	vishwamitra
ट्रम्प	trump
यीशु	jesus
प्लूटो	pluto
डेनियल	daniel
डेनियल	danilo
पैरिस	paris
इयान	ian
अमरीश	amrish
जमैका	jamaica
इज़राइल	israel
अर्ल	earl
वेदान्त	vedanta
ओमान	oman
लीन	lyn
मालवीय	malviya
मैडोना	madonna
बराक	barack
बराक	barak
कल्कि	kalki
इसराइल	israel
वाट	watt
वाट	wat
कोच्चि	kochi
इंडीज़	indies
पूना	poona
दत्ता	datta
दत्ता	dutta
रणवीर	ranvir
रणवीर	ranveer
राजपूतों	rajputs
बेखम	beckham
वासुदेव	vasudev
रॉस	ross
बालाजी	balaji
पांडवों	pandavas
रेसलमेनिया	wrestlemania
नामीबिया	namibia
एनी	annie
मामा	mama
जैकी	jackie
जैकी	jacky
कोबेन	cobain
विवेकानन्द	vivekananda
धोनी	dhoni
जोनाथन	jonathan
गोपीनाथ	gopinath
सिकन्दर	sikander
मीणा	meena
कैनेडी	kennedy
वॉकर	walker
अरविंद	aravind
अरविंद	arvind
फिजी	fiji
फिल	phil
फिलीपींस	philippines
मुरलीधरन	muralitharan
केन्या	kenya
महानदी	mahanadi
बिड़ला	birla
शेन	shane
असीम	asim
दांते	dante
सीबीआई	cbi
किंगफिशर	kingfisher
मुराद	murad
केली	kelly
केली	kaylee
सर्बिया	serbia
स्प्रिंगस्टीन	springsteen
शेंगेन	schengen
ओबेरॉय	oberoi
सिएटल	seattle
प्रिया	priya
रोहिणी	rohini
मैक्सिकन	mexican
कोलम्बिया	colombia
छत्रपति	chhatrapati
स्टीवन	steven
रीड	reed
इसरो	isro
एमी	amy
एमी	emmy
रवीन्द्र	ravindra
प्लेटो	plato
बाजीराव	bajirao
रॉन	ron
बनर्जी	banerjee
इंटेल	intel
मोहित	mohit
कैरी	carrie
कैरी	carey
पेशावर	peshawar
फ्रैंकलिन	franklin
प्रवीण	pravin
प्रवीण	praveen
मैनहटन	manhattan
मॉरीशस	mauritius
गंगाधर	gangadhar
बायर	bayer
रोचेस्टर	rochester
डोनाल्ड	donald
कार्टर	carter
दार्जिलिंग	darjeeling
वेस्टमिंस्टर	westminster
म्यूनिख	munich
शरीफ	sharif
शाहजहाँपुर	shahjahanpur
इंडीज	indies
टायसन	tyson
समीर	samir
जिन्ना	jinnah
फेरारी	ferrari
माईस्पेस	myspace
बलराम	balram
बलराम	balarama
एमआईटी	mit
पालिका	palika
सेठी	sethi
हमीरपुर	hamirpur
