पाइप	pipe
पाइप	pipes
त्रिभुज	eagle
रूम	rooms
रूम	room
जज	judge
व्यवसायिक	profession
छद्म	pseudo
राउंड	round
बेरी	beri
बेरी	berry
तेरे	tere
रा	ra
हॉप	hop
गेज	gauge
वैली	wally
चोर	chor
कॉपी	copied
कॉपी	copy
कॉपी	copies
कमेटी	committee
दाने	grains
आभासी	virtual
मेगावाट	mw
होस्ट	host
होस्ट	hosts
जवान	jawan
अंदरूनी	aralia
डॉग	dog
टूल	tools
उदा	ex
गार्ड	guards
गार्ड	guard
बेसिक	basic
फेडरेशन	federation
क्रीम	cream
परेड	parade
रुद्र	rudra
पाण्डवों	pandavas
बरेली	bareilly
लेनी	leni
धवन	dhawan
देह	body
देह	deh
शिला	shillong
भैरव	bhairava
गुरुकुल	gurukul
चैन	chan
चैन	chain
क्लान	klan
पिक्चर	picture
पिक्चर	pixar
परीक्षित	parikshit
वाइन	wine
बेल्ट	belts
बेल्ट	belt
प्लेस	place
एनीमेशन	optimization
नॉन	non
रांची	ranchi
सीकर	sikar
ड्रीम	dream
कैप्टन	capt
कैप्टन	captain
दरभंगा	darbhanga
सिस्टम्स	systems
निपटान	settlement
स्वीडिश	sweden
शारदा	sarada
सिखों	sikh
लेट	late
जेरी	jere
आइलैंड	island
मयूर	mayur
रिलायंस	reliance
कमला	kamla
कमर	qamar
कॉमिक	comic
नीली	nilgai
गोरखा	gurkha
इन्टरनेट	interrupt
कैपिटल	capitals
कैपिटल	capitol
पुरोहित	purohit
स्पिन	spin
स्पिन	pints
स्टेज	stages
स्टेज	stage
वामन	vaman
दीप	deep
बंधक	mortgage
एंटीबॉडी	antibody
लैंड	land
कॉमन्स	commons
बेसिन	basin
खोटे	khote
चार्टर	charter
स्टेम	stem
पोलिश	polish
लोहिया	lohia
डेक	deck
युवराज	yuvraj
लेग	leg
चिकन	chicken
सामयिक	timely
अलवर	alwar
प्रोफ़ेसर	professor
सुर	sur
पंत	pant
उस्ताद	ustad
सहाय	sahay
हिल्स	hills
मैट	matte
इज़	iz
रास	ras
रास	weasel
घात	ambush
मोह	moh
कभार	sparingly
सीनेट	senate
रेशे	silk
आतंक	terrorism
ईथर	aether
पढ़े	reads
मोटर्स	motors
यूनिवर्सल	universal
फॉर्म	form
पेशवा	peshwa
अभूतपूर्व	phenomenal
ग्रीवा	cervix
सर्जन	surgeon
क्षारीय	align
गन	gun
दरगाह	dargah
धूम	dhoom
ऑयल	oil
सुदर्शन	sudarshan
सॉसेज	sausage
कारगर	operant
कॉलेजों	colleges
असुर	asura
लैस	lacy
शंख	shankha
चिन	chin
बॉडी	body
बोतल	bottle
चेन	chen
चेन	chain
सान	san
कलश	pot
कलश	kalash
गुंजन	gunjan
एस्टेट	estate
वॉल्ट	vault
अयोग्य	worthless
पंचमी	panchami
कोकेन	cocaine
दयाल	dayal
उमर	umar
तोमर	tomar
प्रीमियम	premiums
प्रीमियम	premium
एक्सेस	access
स्क्रिप्ट	scripts
स्क्रिप्ट	script
गर्भगृह	cella
गर्भगृह	sanctum
डिजाइनर	designer
फेयर	fair
शंकु	conic
घोटाले	scandal
रनों	runs
राजी	persuade
ऑब्जेक्ट	object
ऑब्जेक्ट	objects
पेंटिंग	painting
आचार्यों	acharyas
कलन	calculus
व्यू	doorman
प्रौढ़	adult
धड़	torso
पैकेट	packet
भागीदार	participants
भागीदार	participant
वान	van
क्लाइंट	client
क्लाइंट	clients
यन्त्र	yantra
गर्भाधान	insemination
डायरी	diary
अपडेट	update
अपडेट	updates
प्रतिरोधक	resistor
आयुर्वेदिक	ayurveda
वाइस	vice
किट	kit
हिसार	hisar
युगों	yuga
पीपी	pp
ब्लेड	blade
ब्लेड	blades
सदिश	vector
सदिश	vectors
बलिया	ballia
शर्ट	shirt
शर्ट	shirts
तेरी	teri
सेंसर	sensors
सेंसर	sensor
स्टैंड	stand
स्टैंड	stands
एकदिवसीय	odi
कार्गो	cargo
शुभारंभ	launching
प्रतिबद्धता	commitment
डू	doo
कॉफ़ी	cutoff
वीणा	veena
बारूद	gunpowder
चलाना	exec
दादी	mamacita
स्तोत्र	stotra
प्रशस्त	paved
रीडर	reader
सामंत	samanta
कार्बोनेट	carbonate
बर्ड	bird
एथलेटिक्स	athletics
लीड	leads
लीड	lead
परमार	parmar
पंकज	pankaj
संवेदना	condolences
सॉफ़्टवेयर	software
ग्रीनहाउस	greenhouse
कैम्प	camp
कैम्प	camps
हा	ha
छुटकारा	rescues
एथलीट	athlete
एथलीट	athletes
नल	null
प्रेसीडेंसी	presidency
कुक	cook
मनी	mani
चढ़	rust
कारें	cars
दरिया	darya
विलास	vilas
आर्क	arc
प्रोटोटाइप	prototype
अभय	abhay
सिलसिले	silas
कुरु	kuru
कुलपति	vc
मुंशी	munshi
सूत	sut
सीना	cena
आंग्ल	anglo
समता	samata
एवेन्यू	avenue
लोकपाल	lokpal
मार्केटिंग	marketing
चीता	leopard
स्मार्ट	smart
कादर	kader
स्पीकर	speaker
यों	plank
डीडी	dd
कच्छ	kutch
संख्यात्मक	numeration
ब्राउजर	browser
शाश्वत	eternity
पहुँचकर	afflict
मैनुअल	manual
दर्जन	dozen
अश्लील	porn
कमांड	commands
कमांड	command
काई	kai
हस्त	hasta
हस्त	handmade
गढ़ी	garhi
फ्लाइट	flight
टाई	tie
धनबाद	dhanbad
गा	ga
लेआउट	layout
रिटर्न	returns
रिटर्न	return
प्लैटिनम	platinum
मुंडे	munde
लोकमान्य	lokmanya
फ्रेमवर्क	framework
कस्टम	customs
कस्टम	custom
गोमती	gomti
आंत्र	typhoid
आईपी	ip
माली	maldives
टायर	tires
टायर	tyres
टायर	tyre
टायर	tire
उर्वर	exuberant
टेल	tale
टेल	tail
बालिका	balika
मीन	pisces
सेम	sem
इटावा	etawah
मंडप	mandapa
वैद्य	vaidya
उर्फ़	urf
बाह	bah
नेताजी	netaji
जामा	jama
नासिक	nashik
सेकेंड	second
महापौर	mayor
कुंवर	kunwar
हब	hub
मातृ	maternal
नाल	naal
नूतन	nutan
रमन	raman
पटियाला	patiala
घराने	genres
सीटी	ct
परोसा	served
उपनिवेशवाद	colony
चिप्स	chips
गुड़	molasses
चन्द	chand
विधियां	methods
टिहरी	tehri
नैनोट्यूब	nanotube
शीट	sheet
शीट	sheets
पैकेजिंग	packaging
गुम्बद	dome
गुम्बद	domes
नोबल	noble
टंडन	tandon
ऑर	orr
एनिमेशन	animation
एनिमेशन	animations
